function_name,label,degree,neighbors_count,in_degree,out_degree,self_loops,max_call_circles,MLOC,PAR,DOC,fileName,lineno
ansible.__main__._short_name,13,2,1,1,1,0,0,2.0,1.0,0.0,D:\BaiduNetdiskDownload\graduation_project\project_folder\ansible\__main__.py,13.0
ansible.__main__.main,17,5,3,2,3,1,1,22.0,1.0,0.0,D:\BaiduNetdiskDownload\graduation_project\project_folder\ansible\__main__.py,17.0
ansible._vendor.__init__._ensure_vendored_path_entry,23,4,3,1,3,0,0,20.0,1.0,0.0,D:\BaiduNetdiskDownload\graduation_project\project_folder\ansible\_vendor\__init__.py,23.0
ansible.cli.__init__.CLI.__init__,128,1,1,0,1,0,0,18.0,2.0,0.0,D:\BaiduNetdiskDownload\graduation_project\project_folder\ansible\cli\__init__.py,128.0
ansible.cli.__init__.CLI._get_secret,323,2,1,1,1,0,0,6.0,1.0,0.0,D:\BaiduNetdiskDownload\graduation_project\project_folder\ansible\cli\__init__.py,323.0
ansible.cli.__init__.CLI._play_prereqs,531,15,11,4,11,0,0,39.0,1.0,0.0,D:\BaiduNetdiskDownload\graduation_project\project_folder\ansible\cli\__init__.py,531.0
ansible.cli.__init__.CLI.ask_passwords,331,6,3,3,3,0,0,29.0,1.0,0.0,D:\BaiduNetdiskDownload\graduation_project\project_folder\ansible\cli\__init__.py,331.0
ansible.cli.__init__.CLI.build_vault_ids,196,2,1,1,1,0,0,23.0,1.0,0.0,D:\BaiduNetdiskDownload\graduation_project\project_folder\ansible\cli\__init__.py,196.0
ansible.cli.__init__.CLI.cli_executor,632,15,6,9,6,0,0,69.0,1.0,0.0,D:\BaiduNetdiskDownload\graduation_project\project_folder\ansible\cli\__init__.py,632.0
ansible.cli.__init__.CLI.get_host_list,572,6,4,2,4,0,0,16.0,2.0,0.0,D:\BaiduNetdiskDownload\graduation_project\project_folder\ansible\cli\__init__.py,572.0
ansible.cli.__init__.CLI.get_password_from_file,590,9,8,1,8,0,0,40.0,1.0,0.0,D:\BaiduNetdiskDownload\graduation_project\project_folder\ansible\cli\__init__.py,590.0
ansible.cli.__init__.CLI.init_parser,371,1,0,1,0,0,0,15.0,1.0,0.0,D:\BaiduNetdiskDownload\graduation_project\project_folder\ansible\cli\__init__.py,371.0
ansible.cli.__init__.CLI.pager,499,13,2,11,2,0,0,17.0,1.0,0.0,D:\BaiduNetdiskDownload\graduation_project\project_folder\ansible\cli\__init__.py,499.0
ansible.cli.__init__.CLI.pager_pipe,518,2,1,1,1,0,0,11.0,1.0,0.0,D:\BaiduNetdiskDownload\graduation_project\project_folder\ansible\cli\__init__.py,518.0
ansible.cli.__init__.CLI.parse,448,3,2,1,2,0,0,23.0,1.0,0.0,D:\BaiduNetdiskDownload\graduation_project\project_folder\ansible\cli\__init__.py,448.0
ansible.cli.__init__.CLI.post_process_args,388,6,5,1,5,0,0,59.0,2.0,0.0,D:\BaiduNetdiskDownload\graduation_project\project_folder\ansible\cli\__init__.py,388.0
ansible.cli.__init__.CLI.run,148,7,7,0,7,0,0,35.0,1.0,0.0,D:\BaiduNetdiskDownload\graduation_project\project_folder\ansible\cli\__init__.py,148.0
ansible.cli.__init__.CLI.setup_vault_secrets,221,12,10,2,10,0,0,100.0,2.0,0.0,D:\BaiduNetdiskDownload\graduation_project\project_folder\ansible\cli\__init__.py,221.0
ansible.cli.__init__.CLI.split_vault_id,185,2,1,1,1,0,0,9.0,1.0,0.0,D:\BaiduNetdiskDownload\graduation_project\project_folder\ansible\cli\__init__.py,185.0
ansible.cli.__init__.CLI.validate_conflicts,361,5,0,5,0,0,0,8.0,2.0,0.0,D:\BaiduNetdiskDownload\graduation_project\project_folder\ansible\cli\__init__.py,361.0
ansible.cli.__init__.CLI.version_info,473,4,3,1,3,0,0,24.0,0.0,0.0,D:\BaiduNetdiskDownload\graduation_project\project_folder\ansible\cli\__init__.py,473.0
ansible.cli.__init__.check_blocking_io,21,3,2,1,2,0,0,17.0,1.0,0.0,D:\BaiduNetdiskDownload\graduation_project\project_folder\ansible\cli\__init__.py,21.0
ansible.cli.__init__.initialize_locale,43,2,1,1,1,0,0,18.0,1.0,0.0,D:\BaiduNetdiskDownload\graduation_project\project_folder\ansible\cli\__init__.py,43.0
ansible.cli.adhoc.AdHocCLI._play_ds,72,6,5,1,5,0,0,27.0,4.0,0.0,D:\BaiduNetdiskDownload\graduation_project\project_folder\ansible\cli\adhoc.py,72.0
ansible.cli.adhoc.AdHocCLI.init_parser,33,1,1,0,1,0,0,28.0,1.0,0.0,D:\BaiduNetdiskDownload\graduation_project\project_folder\ansible\cli\adhoc.py,33.0
ansible.cli.adhoc.AdHocCLI.post_process_args,62,1,1,0,1,0,0,9.0,2.0,0.0,D:\BaiduNetdiskDownload\graduation_project\project_folder\ansible\cli\adhoc.py,62.0
ansible.cli.adhoc.AdHocCLI.run,100,16,15,1,15,1,1,99.0,1.0,0.0,D:\BaiduNetdiskDownload\graduation_project\project_folder\ansible\cli\adhoc.py,100.0
ansible.cli.adhoc.main,201,2,1,1,1,0,0,2.0,0.0,0.0,D:\BaiduNetdiskDownload\graduation_project\project_folder\ansible\cli\adhoc.py,201.0
ansible.cli.arguments.option_helpers.AnsibleVersion.__call__,44,1,1,0,1,0,0,4.0,4.0,0.0,D:\BaiduNetdiskDownload\graduation_project\project_folder\ansible\cli\arguments\option_helpers.py,44.0
ansible.cli.arguments.option_helpers.ArgumentParser.add_argument,34,46,2,44,2,1,1,7.0,3.0,0.0,D:\BaiduNetdiskDownload\graduation_project\project_folder\ansible\cli\arguments\option_helpers.py,34.0
ansible.cli.arguments.option_helpers.PrependListAction.__call__,84,1,1,0,1,0,0,4.0,4.0,0.0,D:\BaiduNetdiskDownload\graduation_project\project_folder\ansible\cli\arguments\option_helpers.py,84.0
ansible.cli.arguments.option_helpers.SortingHelpFormatter.add_arguments,28,2,1,1,1,1,1,3.0,2.0,0.0,D:\BaiduNetdiskDownload\graduation_project\project_folder\ansible\cli\arguments\option_helpers.py,28.0
ansible.cli.arguments.option_helpers._git_repo_info,121,6,5,1,5,0,0,41.0,1.0,0.0,D:\BaiduNetdiskDownload\graduation_project\project_folder\ansible\cli\arguments\option_helpers.py,121.0
ansible.cli.arguments.option_helpers._gitinfo,164,2,1,1,1,0,0,4.0,1.0,0.0,D:\BaiduNetdiskDownload\graduation_project\project_folder\ansible\cli\arguments\option_helpers.py,164.0
ansible.cli.arguments.option_helpers.add_async_options,227,1,1,0,1,0,0,6.0,1.0,0.0,D:\BaiduNetdiskDownload\graduation_project\project_folder\ansible\cli\arguments\option_helpers.py,227.0
ansible.cli.arguments.option_helpers.add_basedir_options,235,2,2,0,2,0,0,6.0,1.0,0.0,D:\BaiduNetdiskDownload\graduation_project\project_folder\ansible\cli\arguments\option_helpers.py,235.0
ansible.cli.arguments.option_helpers.add_check_options,243,1,1,0,1,0,0,7.0,1.0,0.0,D:\BaiduNetdiskDownload\graduation_project\project_folder\ansible\cli\arguments\option_helpers.py,243.0
ansible.cli.arguments.option_helpers.add_connect_options,252,2,2,0,2,0,0,32.0,1.0,0.0,D:\BaiduNetdiskDownload\graduation_project\project_folder\ansible\cli\arguments\option_helpers.py,252.0
ansible.cli.arguments.option_helpers.add_fork_options,286,1,1,0,1,0,0,4.0,1.0,0.0,D:\BaiduNetdiskDownload\graduation_project\project_folder\ansible\cli\arguments\option_helpers.py,286.0
ansible.cli.arguments.option_helpers.add_inventory_options,292,1,1,0,1,0,0,8.0,1.0,0.0,D:\BaiduNetdiskDownload\graduation_project\project_folder\ansible\cli\arguments\option_helpers.py,292.0
ansible.cli.arguments.option_helpers.add_meta_options,302,1,1,0,1,0,0,6.0,1.0,0.0,D:\BaiduNetdiskDownload\graduation_project\project_folder\ansible\cli\arguments\option_helpers.py,302.0
ansible.cli.arguments.option_helpers.add_module_options,310,2,2,0,2,0,0,6.0,1.0,0.0,D:\BaiduNetdiskDownload\graduation_project\project_folder\ansible\cli\arguments\option_helpers.py,310.0
ansible.cli.arguments.option_helpers.add_output_options,318,1,1,0,1,0,0,6.0,1.0,0.0,D:\BaiduNetdiskDownload\graduation_project\project_folder\ansible\cli\arguments\option_helpers.py,318.0
ansible.cli.arguments.option_helpers.add_runas_options,326,2,2,0,2,0,0,21.0,1.0,0.0,D:\BaiduNetdiskDownload\graduation_project\project_folder\ansible\cli\arguments\option_helpers.py,326.0
ansible.cli.arguments.option_helpers.add_runas_prompt_options,349,3,2,1,2,0,0,19.0,1.0,0.0,D:\BaiduNetdiskDownload\graduation_project\project_folder\ansible\cli\arguments\option_helpers.py,349.0
ansible.cli.arguments.option_helpers.add_runtask_options,370,2,2,0,2,0,0,4.0,1.0,0.0,D:\BaiduNetdiskDownload\graduation_project\project_folder\ansible\cli\arguments\option_helpers.py,370.0
ansible.cli.arguments.option_helpers.add_subset_options,382,1,1,0,1,0,0,6.0,1.0,0.0,D:\BaiduNetdiskDownload\graduation_project\project_folder\ansible\cli\arguments\option_helpers.py,382.0
ansible.cli.arguments.option_helpers.add_tasknoplay_options,376,1,1,0,1,0,0,4.0,1.0,0.0,D:\BaiduNetdiskDownload\graduation_project\project_folder\ansible\cli\arguments\option_helpers.py,376.0
ansible.cli.arguments.option_helpers.add_vault_options,390,2,2,0,2,0,0,9.0,1.0,0.0,D:\BaiduNetdiskDownload\graduation_project\project_folder\ansible\cli\arguments\option_helpers.py,390.0
ansible.cli.arguments.option_helpers.add_verbosity_options,219,2,1,1,1,0,0,6.0,1.0,0.0,D:\BaiduNetdiskDownload\graduation_project\project_folder\ansible\cli\arguments\option_helpers.py,219.0
ansible.cli.arguments.option_helpers.create_base_parser,199,2,2,0,2,0,0,18.0,1.0,0.0,D:\BaiduNetdiskDownload\graduation_project\project_folder\ansible\cli\arguments\option_helpers.py,199.0
ansible.cli.arguments.option_helpers.ensure_value,90,1,0,1,0,0,0,4.0,3.0,0.0,D:\BaiduNetdiskDownload\graduation_project\project_folder\ansible\cli\arguments\option_helpers.py,90.0
ansible.cli.arguments.option_helpers.maybe_unfrack_path,112,3,2,1,2,0,0,7.0,1.0,2.0,D:\BaiduNetdiskDownload\graduation_project\project_folder\ansible\cli\arguments\option_helpers.py,112.0
ansible.cli.arguments.option_helpers.unfrack_path,99,7,2,5,2,0,0,11.0,0.0,2.0,D:\BaiduNetdiskDownload\graduation_project\project_folder\ansible\cli\arguments\option_helpers.py,99.0
ansible.cli.arguments.option_helpers.version,170,5,4,1,4,0,0,23.0,0.0,0.0,D:\BaiduNetdiskDownload\graduation_project\project_folder\ansible\cli\arguments\option_helpers.py,170.0
ansible.cli.config.ConfigCLI._get_global_configs,478,4,3,1,3,0,0,7.0,1.0,0.0,D:\BaiduNetdiskDownload\graduation_project\project_folder\ansible\cli\config.py,478.0
ansible.cli.config.ConfigCLI._get_plugin_configs,486,10,9,1,9,0,0,69.0,3.0,0.0,D:\BaiduNetdiskDownload\graduation_project\project_folder\ansible\cli\config.py,486.0
ansible.cli.config.ConfigCLI._get_settings_ini,353,8,6,2,6,1,1,53.0,3.0,0.0,D:\BaiduNetdiskDownload\graduation_project\project_folder\ansible\cli\config.py,353.0
ansible.cli.config.ConfigCLI._get_settings_vars,296,9,8,1,8,0,0,56.0,3.0,0.0,D:\BaiduNetdiskDownload\graduation_project\project_folder\ansible\cli\config.py,296.0
ansible.cli.config.ConfigCLI._list_entries_from_args,261,6,3,3,3,0,0,21.0,1.0,0.0,D:\BaiduNetdiskDownload\graduation_project\project_folder\ansible\cli\config.py,261.0
ansible.cli.config.ConfigCLI._list_plugin_settings,231,6,5,1,5,0,0,29.0,2.0,0.0,D:\BaiduNetdiskDownload\graduation_project\project_folder\ansible\cli\config.py,231.0
ansible.cli.config.ConfigCLI._render_settings,444,6,4,2,4,0,0,33.0,2.0,0.0,D:\BaiduNetdiskDownload\graduation_project\project_folder\ansible\cli\config.py,444.0
ansible.cli.config.ConfigCLI.execute_dump,556,10,10,0,10,0,0,35.0,1.0,0.0,D:\BaiduNetdiskDownload\graduation_project\project_folder\ansible\cli\config.py,556.0
ansible.cli.config.ConfigCLI.execute_edit,217,3,3,0,3,0,0,13.0,1.0,0.0,D:\BaiduNetdiskDownload\graduation_project\project_folder\ansible\cli\config.py,217.0
ansible.cli.config.ConfigCLI.execute_init,407,9,9,0,9,0,0,36.0,1.0,0.0,D:\BaiduNetdiskDownload\graduation_project\project_folder\ansible\cli\config.py,407.0
ansible.cli.config.ConfigCLI.execute_list,283,5,5,0,5,0,0,12.0,1.0,0.0,D:\BaiduNetdiskDownload\graduation_project\project_folder\ansible\cli\config.py,283.0
ansible.cli.config.ConfigCLI.execute_update,183,2,2,0,2,0,0,23.0,1.0,0.0,D:\BaiduNetdiskDownload\graduation_project\project_folder\ansible\cli\config.py,183.0
ansible.cli.config.ConfigCLI.execute_validate,592,9,9,0,9,0,0,57.0,1.0,0.0,D:\BaiduNetdiskDownload\graduation_project\project_folder\ansible\cli\config.py,592.0
ansible.cli.config.ConfigCLI.execute_view,207,4,4,0,4,0,0,9.0,1.0,0.0,D:\BaiduNetdiskDownload\graduation_project\project_folder\ansible\cli\config.py,207.0
ansible.cli.config.ConfigCLI.init_parser,95,1,1,0,1,0,0,46.0,1.0,0.0,D:\BaiduNetdiskDownload\graduation_project\project_folder\ansible\cli\config.py,95.0
ansible.cli.config.ConfigCLI.run,148,5,5,0,5,0,0,34.0,1.0,0.0,D:\BaiduNetdiskDownload\graduation_project\project_folder\ansible\cli\config.py,148.0
ansible.cli.config._ansible_env_vars,53,2,1,1,1,0,0,9.0,1.0,0.0,D:\BaiduNetdiskDownload\graduation_project\project_folder\ansible\cli\config.py,53.0
ansible.cli.config._get_evar_list,64,2,1,1,1,0,0,7.0,1.0,0.0,D:\BaiduNetdiskDownload\graduation_project\project_folder\ansible\cli\config.py,64.0
ansible.cli.config._get_ini_entries,73,2,1,1,1,0,0,9.0,1.0,0.0,D:\BaiduNetdiskDownload\graduation_project\project_folder\ansible\cli\config.py,73.0
ansible.cli.config.get_constants,46,6,1,5,1,0,0,5.0,1.0,0.0,D:\BaiduNetdiskDownload\graduation_project\project_folder\ansible\cli\config.py,46.0
ansible.cli.config.main,651,2,1,1,1,0,0,2.0,0.0,0.0,D:\BaiduNetdiskDownload\graduation_project\project_folder\ansible\cli\config.py,651.0
ansible.cli.config.yaml_dump,38,12,0,12,0,0,0,2.0,1.0,0.0,D:\BaiduNetdiskDownload\graduation_project\project_folder\ansible\cli\config.py,38.0
ansible.cli.config.yaml_short,42,2,1,1,1,0,0,2.0,1.0,0.0,D:\BaiduNetdiskDownload\graduation_project\project_folder\ansible\cli\config.py,42.0
ansible.cli.console.ConsoleCLI.__getattr__,581,4,4,0,4,0,0,19.0,2.0,0.0,D:\BaiduNetdiskDownload\graduation_project\project_folder\ansible\cli\console.py,581.0
ansible.cli.console.ConsoleCLI.cmdloop,133,5,3,2,3,1,1,10.0,1.0,0.0,D:\BaiduNetdiskDownload\graduation_project\project_folder\ansible\cli\console.py,133.0
ansible.cli.console.ConsoleCLI.complete_cd,497,3,3,0,3,0,0,10.0,5.0,0.0,D:\BaiduNetdiskDownload\graduation_project\project_folder\ansible\cli\console.py,497.0
ansible.cli.console.ConsoleCLI.completedefault,508,4,4,0,4,0,0,7.0,5.0,0.0,D:\BaiduNetdiskDownload\graduation_project\project_folder\ansible\cli\console.py,508.0
ansible.cli.console.ConsoleCLI.default,159,15,12,3,12,0,2,87.0,2.0,0.0,D:\BaiduNetdiskDownload\graduation_project\project_folder\ansible\cli\console.py,159.0
ansible.cli.console.ConsoleCLI.do_become,376,4,4,0,4,0,0,8.0,2.0,0.0,D:\BaiduNetdiskDownload\graduation_project\project_folder\ansible\cli\console.py,376.0
ansible.cli.console.ConsoleCLI.do_become_method,411,2,2,0,2,0,0,8.0,2.0,0.0,D:\BaiduNetdiskDownload\graduation_project\project_folder\ansible\cli\console.py,411.0
ansible.cli.console.ConsoleCLI.do_become_user,399,3,3,0,3,0,0,8.0,2.0,0.0,D:\BaiduNetdiskDownload\graduation_project\project_folder\ansible\cli\console.py,399.0
ansible.cli.console.ConsoleCLI.do_cd,334,2,2,0,2,0,0,19.0,2.0,0.0,D:\BaiduNetdiskDownload\graduation_project\project_folder\ansible\cli\console.py,334.0
ansible.cli.console.ConsoleCLI.do_check,423,3,3,0,3,0,0,8.0,2.0,0.0,D:\BaiduNetdiskDownload\graduation_project\project_folder\ansible\cli\console.py,423.0
ansible.cli.console.ConsoleCLI.do_collections,295,6,6,0,6,0,0,17.0,2.0,0.0,D:\BaiduNetdiskDownload\graduation_project\project_folder\ansible\cli\console.py,295.0
ansible.cli.console.ConsoleCLI.do_diff,435,3,3,0,3,0,0,8.0,2.0,0.0,D:\BaiduNetdiskDownload\graduation_project\project_folder\ansible\cli\console.py,435.0
ansible.cli.console.ConsoleCLI.do_exit,468,1,0,1,0,0,0,4.0,2.0,0.0,D:\BaiduNetdiskDownload\graduation_project\project_folder\ansible\cli\console.py,468.0
ansible.cli.console.ConsoleCLI.do_forks,267,4,4,0,4,0,0,17.0,2.0,0.0,D:\BaiduNetdiskDownload\graduation_project\project_folder\ansible\cli\console.py,267.0
ansible.cli.console.ConsoleCLI.do_list,361,3,3,0,3,0,0,11.0,2.0,0.0,D:\BaiduNetdiskDownload\graduation_project\project_folder\ansible\cli\console.py,361.0
ansible.cli.console.ConsoleCLI.do_remote_user,388,2,2,0,2,0,0,7.0,2.0,0.0,D:\BaiduNetdiskDownload\graduation_project\project_folder\ansible\cli\console.py,388.0
ansible.cli.console.ConsoleCLI.do_shell,250,1,1,0,1,0,0,13.0,2.0,0.0,D:\BaiduNetdiskDownload\graduation_project\project_folder\ansible\cli\console.py,250.0
ansible.cli.console.ConsoleCLI.do_timeout,447,3,3,0,3,0,0,13.0,2.0,0.0,D:\BaiduNetdiskDownload\graduation_project\project_folder\ansible\cli\console.py,447.0
ansible.cli.console.ConsoleCLI.do_verbosity,320,4,4,0,4,0,0,10.0,2.0,0.0,D:\BaiduNetdiskDownload\graduation_project\project_folder\ansible\cli\console.py,320.0
ansible.cli.console.ConsoleCLI.help_become,385,1,1,0,1,0,0,2.0,1.0,0.0,D:\BaiduNetdiskDownload\graduation_project\project_folder\ansible\cli\console.py,385.0
ansible.cli.console.ConsoleCLI.help_become_method,420,1,1,0,1,0,0,2.0,1.0,0.0,D:\BaiduNetdiskDownload\graduation_project\project_folder\ansible\cli\console.py,420.0
ansible.cli.console.ConsoleCLI.help_become_user,408,1,1,0,1,0,0,2.0,1.0,0.0,D:\BaiduNetdiskDownload\graduation_project\project_folder\ansible\cli\console.py,408.0
ansible.cli.console.ConsoleCLI.help_cd,354,2,2,0,2,0,0,3.0,1.0,0.0,D:\BaiduNetdiskDownload\graduation_project\project_folder\ansible\cli\console.py,354.0
ansible.cli.console.ConsoleCLI.help_check,432,1,1,0,1,0,0,2.0,1.0,0.0,D:\BaiduNetdiskDownload\graduation_project\project_folder\ansible\cli\console.py,432.0
ansible.cli.console.ConsoleCLI.help_collections,313,2,2,0,2,0,0,3.0,1.0,0.0,D:\BaiduNetdiskDownload\graduation_project\project_folder\ansible\cli\console.py,313.0
ansible.cli.console.ConsoleCLI.help_diff,444,1,1,0,1,0,0,2.0,1.0,0.0,D:\BaiduNetdiskDownload\graduation_project\project_folder\ansible\cli\console.py,444.0
ansible.cli.console.ConsoleCLI.help_exit,473,1,1,0,1,0,0,2.0,1.0,0.0,D:\BaiduNetdiskDownload\graduation_project\project_folder\ansible\cli\console.py,473.0
ansible.cli.console.ConsoleCLI.help_forks,285,2,2,0,2,0,0,3.0,1.0,0.0,D:\BaiduNetdiskDownload\graduation_project\project_folder\ansible\cli\console.py,285.0
ansible.cli.console.ConsoleCLI.help_help,494,1,1,0,1,0,0,2.0,1.0,0.0,D:\BaiduNetdiskDownload\graduation_project\project_folder\ansible\cli\console.py,494.0
ansible.cli.console.ConsoleCLI.help_list,373,2,1,1,1,0,0,2.0,1.0,0.0,D:\BaiduNetdiskDownload\graduation_project\project_folder\ansible\cli\console.py,373.0
ansible.cli.console.ConsoleCLI.help_remote_user,396,1,1,0,1,0,0,2.0,1.0,0.0,D:\BaiduNetdiskDownload\graduation_project\project_folder\ansible\cli\console.py,396.0
ansible.cli.console.ConsoleCLI.help_shell,264,1,1,0,1,0,0,2.0,1.0,0.0,D:\BaiduNetdiskDownload\graduation_project\project_folder\ansible\cli\console.py,264.0
ansible.cli.console.ConsoleCLI.help_timeout,461,2,2,0,2,0,0,3.0,1.0,0.0,D:\BaiduNetdiskDownload\graduation_project\project_folder\ansible\cli\console.py,461.0
ansible.cli.console.ConsoleCLI.help_verbosity,331,1,1,0,1,0,0,2.0,1.0,0.0,D:\BaiduNetdiskDownload\graduation_project\project_folder\ansible\cli\console.py,331.0
ansible.cli.console.ConsoleCLI.helpdefault,479,5,3,2,3,0,0,14.0,2.0,0.0,D:\BaiduNetdiskDownload\graduation_project\project_folder\ansible\cli\console.py,479.0
ansible.cli.console.ConsoleCLI.init_parser,103,1,1,0,1,0,0,20.0,1.0,0.0,D:\BaiduNetdiskDownload\graduation_project\project_folder\ansible\cli\console.py,103.0
ansible.cli.console.ConsoleCLI.list_modules,156,3,1,2,1,0,0,2.0,1.0,0.0,D:\BaiduNetdiskDownload\graduation_project\project_folder\ansible\cli\console.py,156.0
ansible.cli.console.ConsoleCLI.module_args,516,1,0,1,0,0,0,4.0,2.0,0.0,D:\BaiduNetdiskDownload\graduation_project\project_folder\ansible\cli\console.py,516.0
ansible.cli.console.ConsoleCLI.post_process_args,124,1,1,0,1,0,0,5.0,2.0,0.0,D:\BaiduNetdiskDownload\graduation_project\project_folder\ansible\cli\console.py,124.0
ansible.cli.console.ConsoleCLI.run,521,10,9,1,9,0,2,59.0,1.0,0.0,D:\BaiduNetdiskDownload\graduation_project\project_folder\ansible\cli\console.py,521.0
ansible.cli.console.ConsoleCLI.set_prompt,144,8,2,6,2,0,0,11.0,1.0,0.0,D:\BaiduNetdiskDownload\graduation_project\project_folder\ansible\cli\console.py,144.0
ansible.cli.console.ConsoleCLI.usage_cd,358,2,1,1,1,0,0,2.0,1.0,0.0,D:\BaiduNetdiskDownload\graduation_project\project_folder\ansible\cli\console.py,358.0
ansible.cli.console.ConsoleCLI.usage_collections,317,3,1,2,1,0,0,2.0,1.0,0.0,D:\BaiduNetdiskDownload\graduation_project\project_folder\ansible\cli\console.py,317.0
ansible.cli.console.ConsoleCLI.usage_forks,289,3,1,2,1,0,0,2.0,1.0,0.0,D:\BaiduNetdiskDownload\graduation_project\project_folder\ansible\cli\console.py,289.0
ansible.cli.console.ConsoleCLI.usage_timeout,465,3,1,2,1,0,0,2.0,1.0,0.0,D:\BaiduNetdiskDownload\graduation_project\project_folder\ansible\cli\console.py,465.0
ansible.cli.console.main,602,2,1,1,1,0,0,2.0,0.0,0.0,D:\BaiduNetdiskDownload\graduation_project\project_folder\ansible\cli\console.py,602.0
ansible.cli.doc.DocCLI._combine_plugin_doc,1035,1,0,1,0,0,0,11.0,6.0,0.0,D:\BaiduNetdiskDownload\graduation_project\project_folder\ansible\cli\doc.py,1035.0
ansible.cli.doc.DocCLI._display_available_roles,644,6,5,1,5,0,0,33.0,2.0,0.0,D:\BaiduNetdiskDownload\graduation_project\project_folder\ansible\cli\doc.py,644.0
ansible.cli.doc.DocCLI._display_role_doc,678,5,4,1,4,0,0,15.0,2.0,0.0,D:\BaiduNetdiskDownload\graduation_project\project_folder\ansible\cli\doc.py,678.0
ansible.cli.doc.DocCLI._dump_yaml,1142,6,2,4,2,0,0,2.0,1.0,0.0,D:\BaiduNetdiskDownload\graduation_project\project_folder\ansible\cli\doc.py,1142.0
ansible.cli.doc.DocCLI._format_version_added,1150,2,0,2,0,0,0,9.0,1.0,0.0,D:\BaiduNetdiskDownload\graduation_project\project_folder\ansible\cli\doc.py,1150.0
ansible.cli.doc.DocCLI._get_collection_filter,766,4,2,2,2,0,0,10.0,1.0,0.0,D:\BaiduNetdiskDownload\graduation_project\project_folder\ansible\cli\doc.py,766.0
ansible.cli.doc.DocCLI._get_keywords_docs,699,9,8,1,8,0,0,66.0,1.0,0.0,D:\BaiduNetdiskDownload\graduation_project\project_folder\ansible\cli\doc.py,699.0
ansible.cli.doc.DocCLI._get_plugin_list_descriptions,1090,5,4,1,4,0,0,38.0,2.0,0.0,D:\BaiduNetdiskDownload\graduation_project\project_folder\ansible\cli\doc.py,1090.0
ansible.cli.doc.DocCLI._get_plugins_docs,797,8,7,1,7,0,0,42.0,3.0,0.0,D:\BaiduNetdiskDownload\graduation_project\project_folder\ansible\cli\doc.py,797.0
ansible.cli.doc.DocCLI._get_roles_path,840,2,0,2,0,0,0,16.0,1.0,0.0,D:\BaiduNetdiskDownload\graduation_project\project_folder\ansible\cli\doc.py,840.0
ansible.cli.doc.DocCLI._indent_lines,1146,6,3,3,3,0,0,2.0,2.0,0.0,D:\BaiduNetdiskDownload\graduation_project\project_folder\ansible\cli\doc.py,1146.0
ansible.cli.doc.DocCLI._list_keywords,695,3,1,2,1,0,0,2.0,1.0,0.0,D:\BaiduNetdiskDownload\graduation_project\project_folder\ansible\cli\doc.py,695.0
ansible.cli.doc.DocCLI._list_plugins,777,5,4,1,4,0,0,19.0,3.0,0.0,D:\BaiduNetdiskDownload\graduation_project\project_folder\ansible\cli\doc.py,777.0
ansible.cli.doc.DocCLI._prep_loader,858,3,1,2,1,0,0,17.0,1.0,0.0,D:\BaiduNetdiskDownload\graduation_project\project_folder\ansible\cli\doc.py,858.0
ansible.cli.doc.DocCLI._tty_ify_sem_complex,474,3,3,0,3,0,0,27.0,1.0,0.0,D:\BaiduNetdiskDownload\graduation_project\project_folder\ansible\cli\doc.py,474.0
ansible.cli.doc.DocCLI.add_fields,1170,16,13,3,13,1,1,99.0,4.0,0.0,D:\BaiduNetdiskDownload\graduation_project\project_folder\ansible\cli\doc.py,1170.0
ansible.cli.doc.DocCLI.display_plugin_list,597,8,7,1,7,0,0,46.0,2.0,0.0,D:\BaiduNetdiskDownload\graduation_project\project_folder\ansible\cli\doc.py,597.0
ansible.cli.doc.DocCLI.format_plugin_doc,1068,4,3,1,3,0,0,21.0,6.0,0.0,D:\BaiduNetdiskDownload\graduation_project\project_folder\ansible\cli\doc.py,1068.0
ansible.cli.doc.DocCLI.format_snippet,1048,6,5,1,5,0,0,18.0,3.0,0.0,D:\BaiduNetdiskDownload\graduation_project\project_folder\ansible\cli\doc.py,1048.0
ansible.cli.doc.DocCLI.get_all_plugins_of_type,985,2,2,0,2,0,0,7.0,1.0,0.0,D:\BaiduNetdiskDownload\graduation_project\project_folder\ansible\cli\doc.py,985.0
ansible.cli.doc.DocCLI.get_man_text,1356,18,17,1,17,0,0,153.0,1.0,0.0,D:\BaiduNetdiskDownload\graduation_project\project_folder\ansible\cli\doc.py,1356.0
ansible.cli.doc.DocCLI.get_plugin_metadata,994,6,6,0,6,0,0,26.0,2.0,0.0,D:\BaiduNetdiskDownload\graduation_project\project_folder\ansible\cli\doc.py,994.0
ansible.cli.doc.DocCLI.get_role_man_text,1270,14,13,1,13,0,0,84.0,3.0,0.0,D:\BaiduNetdiskDownload\graduation_project\project_folder\ansible\cli\doc.py,1270.0
ansible.cli.doc.DocCLI.init_parser,536,3,3,0,3,0,0,53.0,1.0,0.0,D:\BaiduNetdiskDownload\graduation_project\project_folder\ansible\cli\doc.py,536.0
ansible.cli.doc.DocCLI.namespace_from_plugin_filepath,1022,5,4,1,4,0,0,11.0,3.0,0.0,D:\BaiduNetdiskDownload\graduation_project\project_folder\ansible\cli\doc.py,1022.0
ansible.cli.doc.DocCLI.print_paths,1130,3,3,0,3,0,0,10.0,1.0,0.0,D:\BaiduNetdiskDownload\graduation_project\project_folder\ansible\cli\doc.py,1130.0
ansible.cli.doc.DocCLI.run,876,22,22,0,22,0,0,107.0,1.0,0.0,D:\BaiduNetdiskDownload\graduation_project\project_folder\ansible\cli\doc.py,876.0
ansible.cli.doc.DocCLI.tty_ify,503,10,3,7,3,0,0,32.0,2.0,0.0,D:\BaiduNetdiskDownload\graduation_project\project_folder\ansible\cli\doc.py,503.0
ansible.cli.doc.DocCLI.warp_fill,1161,7,3,4,3,0,0,7.0,3.0,0.0,D:\BaiduNetdiskDownload\graduation_project\project_folder\ansible\cli\doc.py,1161.0
ansible.cli.doc.RoleMixin._build_doc,283,2,1,1,1,0,0,22.0,6.0,0.0,D:\BaiduNetdiskDownload\graduation_project\project_folder\ansible\cli\doc.py,283.0
ansible.cli.doc.RoleMixin._build_summary,252,2,1,1,1,0,0,30.0,5.0,0.0,D:\BaiduNetdiskDownload\graduation_project\project_folder\ansible\cli\doc.py,252.0
ansible.cli.doc.RoleMixin._create_role_doc,367,6,5,1,5,0,0,22.0,2.0,0.0,D:\BaiduNetdiskDownload\graduation_project\project_folder\ansible\cli\doc.py,367.0
ansible.cli.doc.RoleMixin._create_role_list,306,10,9,1,9,0,0,60.0,1.0,0.0,D:\BaiduNetdiskDownload\graduation_project\project_folder\ansible\cli\doc.py,306.0
ansible.cli.doc.RoleMixin._find_all_collection_roles,210,8,6,2,6,0,0,41.0,1.0,0.0,D:\BaiduNetdiskDownload\graduation_project\project_folder\ansible\cli\doc.py,210.0
ansible.cli.doc.RoleMixin._find_all_normal_roles,173,3,1,2,1,0,0,36.0,2.0,0.0,D:\BaiduNetdiskDownload\graduation_project\project_folder\ansible\cli\doc.py,173.0
ansible.cli.doc.RoleMixin._load_argspec,148,3,1,2,1,0,0,24.0,4.0,0.0,D:\BaiduNetdiskDownload\graduation_project\project_folder\ansible\cli\doc.py,148.0
ansible.cli.doc.RoleMixin._load_metadata,133,2,1,1,1,0,0,14.0,4.0,0.0,D:\BaiduNetdiskDownload\graduation_project\project_folder\ansible\cli\doc.py,133.0
ansible.cli.doc.RoleMixin._load_role_data,97,4,2,2,2,0,0,35.0,5.0,0.0,D:\BaiduNetdiskDownload\graduation_project\project_folder\ansible\cli\doc.py,97.0
ansible.cli.doc._do_lookup_snippet,1556,3,2,1,2,0,0,36.0,1.0,0.0,D:\BaiduNetdiskDownload\graduation_project\project_folder\ansible\cli\doc.py,1556.0
ansible.cli.doc._do_yaml_snippet,1511,6,5,1,5,0,0,43.0,1.0,0.0,D:\BaiduNetdiskDownload\graduation_project\project_folder\ansible\cli\doc.py,1511.0
ansible.cli.doc._doclink,391,3,2,1,2,0,0,5.0,1.0,0.0,D:\BaiduNetdiskDownload\graduation_project\project_folder\ansible\cli\doc.py,391.0
ansible.cli.doc._format,398,6,2,4,2,0,0,23.0,2.0,0.0,D:\BaiduNetdiskDownload\graduation_project\project_folder\ansible\cli\doc.py,398.0
ansible.cli.doc.jdump,78,5,4,1,4,0,0,6.0,1.0,0.0,D:\BaiduNetdiskDownload\graduation_project\project_folder\ansible\cli\doc.py,78.0
ansible.cli.doc.main,1594,2,1,1,1,0,0,2.0,0.0,0.0,D:\BaiduNetdiskDownload\graduation_project\project_folder\ansible\cli\doc.py,1594.0
ansible.cli.galaxy.GalaxyCLI.__init__,212,3,3,0,3,0,0,23.0,2.0,0.0,D:\BaiduNetdiskDownload\graduation_project\project_folder\ansible\cli\galaxy.py,212.0
ansible.cli.galaxy.GalaxyCLI._display_role_info,905,4,3,1,3,0,0,26.0,1.0,0.0,D:\BaiduNetdiskDownload\graduation_project\project_folder\ansible\cli\galaxy.py,905.0
ansible.cli.galaxy.GalaxyCLI._execute_install_collection,1420,9,8,1,8,0,0,55.0,4.0,0.0,D:\BaiduNetdiskDownload\graduation_project\project_folder\ansible\cli\galaxy.py,1420.0
ansible.cli.galaxy.GalaxyCLI._execute_install_role,1476,12,11,1,11,0,0,81.0,2.0,0.0,D:\BaiduNetdiskDownload\graduation_project\project_folder\ansible\cli\galaxy.py,1476.0
ansible.cli.galaxy.GalaxyCLI._get_default_collection_path,756,2,0,2,0,0,0,2.0,1.0,0.0,D:\BaiduNetdiskDownload\graduation_project\project_folder\ansible\cli\galaxy.py,756.0
ansible.cli.galaxy.GalaxyCLI._get_skeleton_galaxy_yml,937,11,10,1,10,0,0,44.0,2.0,2.0,D:\BaiduNetdiskDownload\graduation_project\project_folder\ansible\cli\galaxy.py,937.0
ansible.cli.galaxy.GalaxyCLI._init_coll_req_dict,863,3,2,1,2,0,0,31.0,2.0,0.0,D:\BaiduNetdiskDownload\graduation_project\project_folder\ansible\cli\galaxy.py,863.0
ansible.cli.galaxy.GalaxyCLI._parse_requirements_file,759,11,9,2,9,0,0,103.0,2.0,2.0,D:\BaiduNetdiskDownload\graduation_project\project_folder\ansible\cli\galaxy.py,759.0
ansible.cli.galaxy.GalaxyCLI._require_one_of_collections_requirements,982,7,4,3,4,0,0,31.0,3.0,0.0,D:\BaiduNetdiskDownload\graduation_project\project_folder\ansible\cli\galaxy.py,982.0
ansible.cli.galaxy.GalaxyCLI._resolve_path,933,8,0,8,0,0,0,2.0,1.0,0.0,D:\BaiduNetdiskDownload\graduation_project\project_folder\ansible\cli\galaxy.py,933.0
ansible.cli.galaxy.GalaxyCLI.add_build_options,578,2,1,1,1,0,0,13.0,2.0,0.0,D:\BaiduNetdiskDownload\graduation_project\project_folder\ansible\cli\galaxy.py,578.0
ansible.cli.galaxy.GalaxyCLI.add_delete_options,378,1,0,1,0,0,0,5.0,2.0,0.0,D:\BaiduNetdiskDownload\graduation_project\project_folder\ansible\cli\galaxy.py,378.0
ansible.cli.galaxy.GalaxyCLI.add_download_options,325,2,1,1,1,0,0,18.0,2.0,0.0,D:\BaiduNetdiskDownload\graduation_project\project_folder\ansible\cli\galaxy.py,325.0
ansible.cli.galaxy.GalaxyCLI.add_import_options,411,2,1,1,1,0,0,14.0,2.0,0.0,D:\BaiduNetdiskDownload\graduation_project\project_folder\ansible\cli\galaxy.py,411.0
ansible.cli.galaxy.GalaxyCLI.add_info_options,441,2,1,1,1,0,0,5.0,2.0,0.0,D:\BaiduNetdiskDownload\graduation_project\project_folder\ansible\cli\galaxy.py,441.0
ansible.cli.galaxy.GalaxyCLI.add_init_options,344,4,3,1,3,0,0,27.0,2.0,0.0,D:\BaiduNetdiskDownload\graduation_project\project_folder\ansible\cli\galaxy.py,344.0
ansible.cli.galaxy.GalaxyCLI.add_install_options,483,5,4,1,4,0,0,94.0,2.0,0.0,D:\BaiduNetdiskDownload\graduation_project\project_folder\ansible\cli\galaxy.py,483.0
ansible.cli.galaxy.GalaxyCLI.add_list_options,384,4,3,1,3,0,0,15.0,2.0,0.0,D:\BaiduNetdiskDownload\graduation_project\project_folder\ansible\cli\galaxy.py,384.0
ansible.cli.galaxy.GalaxyCLI.add_publish_options,592,2,1,1,1,0,0,11.0,2.0,0.0,D:\BaiduNetdiskDownload\graduation_project\project_folder\ansible\cli\galaxy.py,592.0
ansible.cli.galaxy.GalaxyCLI.add_remove_options,372,2,1,1,1,0,0,5.0,2.0,0.0,D:\BaiduNetdiskDownload\graduation_project\project_folder\ansible\cli\galaxy.py,372.0
ansible.cli.galaxy.GalaxyCLI.add_search_options,400,2,1,1,1,0,0,10.0,2.0,0.0,D:\BaiduNetdiskDownload\graduation_project\project_folder\ansible\cli\galaxy.py,400.0
ansible.cli.galaxy.GalaxyCLI.add_setup_options,426,2,1,1,1,0,0,14.0,2.0,0.0,D:\BaiduNetdiskDownload\graduation_project\project_folder\ansible\cli\galaxy.py,426.0
ansible.cli.galaxy.GalaxyCLI.add_verify_options,447,3,2,1,2,0,0,35.0,2.0,0.0,D:\BaiduNetdiskDownload\graduation_project\project_folder\ansible\cli\galaxy.py,447.0
ansible.cli.galaxy.GalaxyCLI.execute_build,1034,5,5,0,5,0,0,22.0,1.0,0.0,D:\BaiduNetdiskDownload\graduation_project\project_folder\ansible\cli\galaxy.py,1034.0
ansible.cli.galaxy.GalaxyCLI.execute_delete,1877,2,2,0,2,0,0,17.0,1.0,0.0,D:\BaiduNetdiskDownload\graduation_project\project_folder\ansible\cli\galaxy.py,1877.0
ansible.cli.galaxy.GalaxyCLI.execute_download,1058,4,4,0,4,0,0,27.0,1.0,0.0,D:\BaiduNetdiskDownload\graduation_project\project_folder\ansible\cli\galaxy.py,1058.0
ansible.cli.galaxy.GalaxyCLI.execute_import,1787,6,6,0,6,0,0,56.0,1.0,0.0,D:\BaiduNetdiskDownload\graduation_project\project_folder\ansible\cli\galaxy.py,1787.0
ansible.cli.galaxy.GalaxyCLI.execute_info,1243,7,7,0,7,0,0,53.0,1.0,0.0,D:\BaiduNetdiskDownload\graduation_project\project_folder\ansible\cli\galaxy.py,1243.0
ansible.cli.galaxy.GalaxyCLI.execute_init,1086,18,18,0,18,0,0,156.0,1.0,0.0,D:\BaiduNetdiskDownload\graduation_project\project_folder\ansible\cli\galaxy.py,1086.0
ansible.cli.galaxy.GalaxyCLI.execute_install,1331,16,16,0,16,0,0,88.0,1.0,0.0,D:\BaiduNetdiskDownload\graduation_project\project_folder\ansible\cli\galaxy.py,1331.0
ansible.cli.galaxy.GalaxyCLI.execute_list,1578,2,2,0,2,0,0,9.0,1.0,0.0,D:\BaiduNetdiskDownload\graduation_project\project_folder\ansible\cli\galaxy.py,1578.0
ansible.cli.galaxy.GalaxyCLI.execute_list_collection,1647,14,13,1,13,0,0,88.0,1.0,0.0,D:\BaiduNetdiskDownload\graduation_project\project_folder\ansible\cli\galaxy.py,1647.0
ansible.cli.galaxy.GalaxyCLI.execute_list_role,1588,9,8,1,8,0,0,57.0,1.0,0.0,D:\BaiduNetdiskDownload\graduation_project\project_folder\ansible\cli\galaxy.py,1588.0
ansible.cli.galaxy.GalaxyCLI.execute_publish,1736,2,2,0,2,0,0,9.0,1.0,0.0,D:\BaiduNetdiskDownload\graduation_project\project_folder\ansible\cli\galaxy.py,1736.0
ansible.cli.galaxy.GalaxyCLI.execute_remove,1558,4,4,0,4,0,0,19.0,1.0,0.0,D:\BaiduNetdiskDownload\graduation_project\project_folder\ansible\cli\galaxy.py,1558.0
ansible.cli.galaxy.GalaxyCLI.execute_search,1746,6,6,0,6,0,0,40.0,1.0,0.0,D:\BaiduNetdiskDownload\graduation_project\project_folder\ansible\cli\galaxy.py,1746.0
ansible.cli.galaxy.GalaxyCLI.execute_setup,1844,4,4,0,4,0,0,32.0,1.0,0.0,D:\BaiduNetdiskDownload\graduation_project\project_folder\ansible\cli\galaxy.py,1844.0
ansible.cli.galaxy.GalaxyCLI.execute_verify,1298,4,4,0,4,0,0,31.0,1.0,0.0,D:\BaiduNetdiskDownload\graduation_project\project_folder\ansible\cli\galaxy.py,1298.0
ansible.cli.galaxy.GalaxyCLI.exit_without_ignore,896,2,1,1,1,0,0,7.0,0.0,0.0,D:\BaiduNetdiskDownload\graduation_project\project_folder\ansible\cli\galaxy.py,896.0
ansible.cli.galaxy.GalaxyCLI.init_parser,236,15,15,0,15,0,0,88.0,1.0,0.0,D:\BaiduNetdiskDownload\graduation_project\project_folder\ansible\cli\galaxy.py,236.0
ansible.cli.galaxy.GalaxyCLI.run,615,11,11,0,11,0,0,136.0,1.0,2.0,D:\BaiduNetdiskDownload\graduation_project\project_folder\ansible\cli\galaxy.py,615.0
ansible.cli.galaxy._display_collection,146,4,3,1,3,0,0,7.0,1.0,0.0,D:\BaiduNetdiskDownload\graduation_project\project_folder\ansible\cli\galaxy.py,146.0
ansible.cli.galaxy._display_header,124,3,2,1,2,0,0,10.0,3.0,0.0,D:\BaiduNetdiskDownload\graduation_project\project_folder\ansible\cli\galaxy.py,124.0
ansible.cli.galaxy._display_role,136,2,1,1,1,0,0,8.0,1.0,0.0,D:\BaiduNetdiskDownload\graduation_project\project_folder\ansible\cli\galaxy.py,136.0
ansible.cli.galaxy._get_collection_widths,155,3,2,1,2,0,0,11.0,1.0,0.0,D:\BaiduNetdiskDownload\graduation_project\project_folder\ansible\cli\galaxy.py,155.0
ansible.cli.galaxy.main,1896,2,1,1,1,0,0,2.0,0.0,0.0,D:\BaiduNetdiskDownload\graduation_project\project_folder\ansible\cli\galaxy.py,1896.0
ansible.cli.galaxy.with_collection_artifacts_manager,91,2,2,0,2,0,0,31.0,1.0,2.0,D:\BaiduNetdiskDownload\graduation_project\project_folder\ansible\cli\galaxy.py,91.0
ansible.cli.inventory.InventoryCLI._get_group,221,2,0,2,0,0,0,14.0,2.0,0.0,D:\BaiduNetdiskDownload\graduation_project\project_folder\ansible\cli\inventory.py,190.0
ansible.cli.inventory.InventoryCLI._get_group_variables,190,8,4,4,4,0,0,14.0,2.0,0.0,D:\BaiduNetdiskDownload\graduation_project\project_folder\ansible\cli\inventory.py,190.0
ansible.cli.inventory.InventoryCLI._get_host_variables,205,9,4,5,4,0,0,15.0,2.0,0.0,D:\BaiduNetdiskDownload\graduation_project\project_folder\ansible\cli\inventory.py,205.0
ansible.cli.inventory.InventoryCLI._graph_group,254,9,7,2,7,1,1,17.0,2.0,0.0,D:\BaiduNetdiskDownload\graduation_project\project_folder\ansible\cli\inventory.py,254.0
ansible.cli.inventory.InventoryCLI._graph_name,249,2,0,2,0,0,0,4.0,1.0,0.0,D:\BaiduNetdiskDownload\graduation_project\project_folder\ansible\cli\inventory.py,249.0
ansible.cli.inventory.InventoryCLI._remove_empty_keys,235,3,0,3,0,0,0,5.0,1.0,0.0,D:\BaiduNetdiskDownload\graduation_project\project_folder\ansible\cli\inventory.py,235.0
ansible.cli.inventory.InventoryCLI._remove_internal,226,2,0,2,0,0,0,7.0,1.0,0.0,D:\BaiduNetdiskDownload\graduation_project\project_folder\ansible\cli\inventory.py,226.0
ansible.cli.inventory.InventoryCLI._show_vars,242,4,3,1,3,0,0,5.0,2.0,0.0,D:\BaiduNetdiskDownload\graduation_project\project_folder\ansible\cli\inventory.py,242.0
ansible.cli.inventory.InventoryCLI.dump,158,4,3,1,3,0,0,31.0,1.0,0.0,D:\BaiduNetdiskDownload\graduation_project\project_folder\ansible\cli\inventory.py,158.0
ansible.cli.inventory.InventoryCLI.init_parser,42,1,1,0,1,0,0,38.0,1.0,0.0,D:\BaiduNetdiskDownload\graduation_project\project_folder\ansible\cli\inventory.py,42.0
ansible.cli.inventory.InventoryCLI.inventory_graph,272,4,3,1,3,0,0,7.0,1.0,0.0,D:\BaiduNetdiskDownload\graduation_project\project_folder\ansible\cli\inventory.py,272.0
ansible.cli.inventory.InventoryCLI.json_inventory,280,6,5,1,5,0,0,36.0,2.0,2.0,D:\BaiduNetdiskDownload\graduation_project\project_folder\ansible\cli\inventory.py,280.0
ansible.cli.inventory.InventoryCLI.post_process_args,83,1,1,0,1,0,0,23.0,2.0,0.0,D:\BaiduNetdiskDownload\graduation_project\project_folder\ansible\cli\inventory.py,83.0
ansible.cli.inventory.InventoryCLI.run,107,13,13,0,13,0,0,49.0,1.0,0.0,D:\BaiduNetdiskDownload\graduation_project\project_folder\ansible\cli\inventory.py,107.0
ansible.cli.inventory.InventoryCLI.toml_inventory,365,6,5,1,5,0,0,45.0,2.0,2.0,D:\BaiduNetdiskDownload\graduation_project\project_folder\ansible\cli\inventory.py,365.0
ansible.cli.inventory.InventoryCLI.yaml_inventory,317,5,4,1,4,0,0,47.0,2.0,2.0,D:\BaiduNetdiskDownload\graduation_project\project_folder\ansible\cli\inventory.py,317.0
ansible.cli.inventory.main,412,2,1,1,1,0,0,2.0,0.0,0.0,D:\BaiduNetdiskDownload\graduation_project\project_folder\ansible\cli\inventory.py,412.0
ansible.cli.playbook.PlaybookCLI._flush_cache,232,3,2,1,2,0,0,4.0,2.0,0.0,D:\BaiduNetdiskDownload\graduation_project\project_folder\ansible\cli\playbook.py,232.0
ansible.cli.playbook.PlaybookCLI.init_parser,37,1,1,0,1,0,0,30.0,1.0,0.0,D:\BaiduNetdiskDownload\graduation_project\project_folder\ansible\cli\playbook.py,37.0
ansible.cli.playbook.PlaybookCLI.post_process_args,68,1,1,0,1,0,0,18.0,2.0,0.0,D:\BaiduNetdiskDownload\graduation_project\project_folder\ansible\cli\playbook.py,68.0
ansible.cli.playbook.PlaybookCLI.run,87,16,16,0,16,0,0,143.0,1.0,0.0,D:\BaiduNetdiskDownload\graduation_project\project_folder\ansible\cli\playbook.py,87.0
ansible.cli.playbook.main,238,2,1,1,1,0,0,2.0,0.0,0.0,D:\BaiduNetdiskDownload\graduation_project\project_folder\ansible\cli\playbook.py,238.0
ansible.cli.pull.PullCLI._get_inv_cli,67,2,1,1,1,0,0,10.0,1.0,0.0,D:\BaiduNetdiskDownload\graduation_project\project_folder\ansible\cli\pull.py,67.0
ansible.cli.pull.PullCLI.init_parser,78,1,1,0,1,0,0,51.0,1.0,0.0,D:\BaiduNetdiskDownload\graduation_project\project_folder\ansible\cli\pull.py,78.0
ansible.cli.pull.PullCLI.post_process_args,130,2,2,0,2,0,0,28.0,2.0,0.0,D:\BaiduNetdiskDownload\graduation_project\project_folder\ansible\cli\pull.py,130.0
ansible.cli.pull.PullCLI.run,159,12,12,0,12,0,0,163.0,1.0,0.0,D:\BaiduNetdiskDownload\graduation_project\project_folder\ansible\cli\pull.py,159.0
ansible.cli.pull.PullCLI.select_playbook,332,6,5,1,5,0,0,32.0,1.0,0.0,D:\BaiduNetdiskDownload\graduation_project\project_folder\ansible\cli\pull.py,332.0
ansible.cli.pull.PullCLI.try_playbook,324,1,0,1,0,0,0,6.0,1.0,0.0,D:\BaiduNetdiskDownload\graduation_project\project_folder\ansible\cli\pull.py,324.0
ansible.cli.pull.main,366,2,1,1,1,0,0,2.0,0.0,0.0,D:\BaiduNetdiskDownload\graduation_project\project_folder\ansible\cli\pull.py,366.0
ansible.cli.scripts.ansible_connection_cli_stub.ConnectionProcess.__init__,64,1,0,1,0,0,0,14.0,5.0,0.0,D:\BaiduNetdiskDownload\graduation_project\project_folder\ansible\cli\scripts\ansible_connection_cli_stub.py,64.0
ansible.cli.scripts.ansible_connection_cli_stub.ConnectionProcess.command_timeout,173,1,1,0,1,0,0,5.0,3.0,0.0,D:\BaiduNetdiskDownload\graduation_project\project_folder\ansible\cli\scripts\ansible_connection_cli_stub.py,173.0
ansible.cli.scripts.ansible_connection_cli_stub.ConnectionProcess.connect_timeout,167,1,1,0,1,0,0,5.0,3.0,0.0,D:\BaiduNetdiskDownload\graduation_project\project_folder\ansible\cli\scripts\ansible_connection_cli_stub.py,167.0
ansible.cli.scripts.ansible_connection_cli_stub.ConnectionProcess.handler,179,1,1,0,1,0,0,4.0,3.0,0.0,D:\BaiduNetdiskDownload\graduation_project\project_folder\ansible\cli\scripts\ansible_connection_cli_stub.py,179.0
ansible.cli.scripts.ansible_connection_cli_stub.ConnectionProcess.run,116,8,7,1,7,0,0,50.0,1.0,0.0,D:\BaiduNetdiskDownload\graduation_project\project_folder\ansible\cli\scripts\ansible_connection_cli_stub.py,116.0
ansible.cli.scripts.ansible_connection_cli_stub.ConnectionProcess.shutdown,184,6,3,3,3,0,0,25.0,1.0,0.0,D:\BaiduNetdiskDownload\graduation_project\project_folder\ansible\cli\scripts\ansible_connection_cli_stub.py,184.0
ansible.cli.scripts.ansible_connection_cli_stub.ConnectionProcess.start,79,9,8,1,8,0,0,36.0,2.0,0.0,D:\BaiduNetdiskDownload\graduation_project\project_folder\ansible\cli\scripts\ansible_connection_cli_stub.py,79.0
ansible.cli.scripts.ansible_connection_cli_stub.file_lock,45,1,0,1,0,0,0,12.0,1.0,0.0,D:\BaiduNetdiskDownload\graduation_project\project_folder\ansible\cli\scripts\ansible_connection_cli_stub.py,45.0
ansible.cli.scripts.ansible_connection_cli_stub.main,211,22,21,1,21,0,0,128.0,0.0,0.0,D:\BaiduNetdiskDownload\graduation_project\project_folder\ansible\cli\scripts\ansible_connection_cli_stub.py,211.0
ansible.cli.scripts.ansible_connection_cli_stub.read_stream,34,3,2,1,2,0,0,8.0,1.0,0.0,D:\BaiduNetdiskDownload\graduation_project\project_folder\ansible\cli\scripts\ansible_connection_cli_stub.py,34.0
ansible.cli.vault.VaultCLI._format_output_vault_strings,400,4,3,1,3,0,0,32.0,2.0,0.0,D:\BaiduNetdiskDownload\graduation_project\project_folder\ansible\cli\vault.py,400.0
ansible.cli.vault.VaultCLI.execute_create,445,1,1,0,1,0,0,11.0,1.0,0.0,D:\BaiduNetdiskDownload\graduation_project\project_folder\ansible\cli\vault.py,445.0
ansible.cli.vault.VaultCLI.execute_decrypt,433,2,2,0,2,0,0,11.0,1.0,0.0,D:\BaiduNetdiskDownload\graduation_project\project_folder\ansible\cli\vault.py,433.0
ansible.cli.vault.VaultCLI.execute_edit,457,1,1,0,1,0,0,4.0,1.0,0.0,D:\BaiduNetdiskDownload\graduation_project\project_folder\ansible\cli\vault.py,457.0
ansible.cli.vault.VaultCLI.execute_encrypt,254,2,2,0,2,0,0,14.0,1.0,0.0,D:\BaiduNetdiskDownload\graduation_project\project_folder\ansible\cli\vault.py,254.0
ansible.cli.vault.VaultCLI.execute_encrypt_string,288,8,8,0,8,0,0,109.0,1.0,0.0,D:\BaiduNetdiskDownload\graduation_project\project_folder\ansible\cli\vault.py,288.0
ansible.cli.vault.VaultCLI.execute_rekey,474,2,2,0,2,0,0,8.0,1.0,0.0,D:\BaiduNetdiskDownload\graduation_project\project_folder\ansible\cli\vault.py,474.0
ansible.cli.vault.VaultCLI.execute_view,462,3,3,0,3,0,0,11.0,1.0,0.0,D:\BaiduNetdiskDownload\graduation_project\project_folder\ansible\cli\vault.py,462.0
ansible.cli.vault.VaultCLI.format_ciphertext_yaml,270,5,4,1,4,0,0,17.0,1.0,0.0,D:\BaiduNetdiskDownload\graduation_project\project_folder\ansible\cli\vault.py,270.0
ansible.cli.vault.VaultCLI.init_parser,57,1,1,0,1,0,0,69.0,1.0,0.0,D:\BaiduNetdiskDownload\graduation_project\project_folder\ansible\cli\vault.py,57.0
ansible.cli.vault.VaultCLI.run,150,8,8,0,8,0,0,103.0,1.0,0.0,D:\BaiduNetdiskDownload\graduation_project\project_folder\ansible\cli\vault.py,150.0
ansible.cli.vault.main,484,2,1,1,1,0,0,2.0,0.0,0.0,D:\BaiduNetdiskDownload\graduation_project\project_folder\ansible\cli\vault.py,484.0
ansible.collections.list.list_collection_dirs,26,8,6,2,6,0,0,38.0,0.0,0.0,D:\BaiduNetdiskDownload\graduation_project\project_folder\ansible\collections\list.py,26.0
ansible.collections.list.list_collections,16,3,2,1,2,0,0,7.0,0.0,0.0,D:\BaiduNetdiskDownload\graduation_project\project_folder\ansible\collections\list.py,16.0
ansible.config.manager.ConfigManager.__init__,282,6,4,2,4,0,0,22.0,1.0,0.0,D:\BaiduNetdiskDownload\graduation_project\project_folder\ansible\config\manager.py,282.0
ansible.config.manager.ConfigManager._loop_entries,423,5,4,1,4,0,0,25.0,3.0,0.0,D:\BaiduNetdiskDownload\graduation_project\project_folder\ansible\config\manager.py,423.0
ansible.config.manager.ConfigManager._parse_config_file,326,6,4,2,4,0,0,26.0,1.0,0.0,D:\BaiduNetdiskDownload\graduation_project\project_folder\ansible\config\manager.py,326.0
ansible.config.manager.ConfigManager._read_config_yaml_file,316,3,2,1,2,0,0,9.0,2.0,0.0,D:\BaiduNetdiskDownload\graduation_project\project_folder\ansible\config\manager.py,316.0
ansible.config.manager.ConfigManager.get_config_value,449,4,2,2,2,0,0,11.0,2.0,0.0,D:\BaiduNetdiskDownload\graduation_project\project_folder\ansible\config\manager.py,449.0
ansible.config.manager.ConfigManager.get_config_value_and_origin,461,15,14,1,14,0,0,152.0,2.0,0.0,D:\BaiduNetdiskDownload\graduation_project\project_folder\ansible\config\manager.py,461.0
ansible.config.manager.ConfigManager.get_configuration_definitions,405,9,1,8,1,0,0,17.0,1.0,0.0,D:\BaiduNetdiskDownload\graduation_project\project_folder\ansible\config\manager.py,405.0
ansible.config.manager.ConfigManager.get_plugin_options,357,2,2,0,2,0,0,8.0,3.0,0.0,D:\BaiduNetdiskDownload\graduation_project\project_folder\ansible\config\manager.py,357.0
ansible.config.manager.ConfigManager.get_plugin_options_from_var,375,3,3,0,3,0,0,9.0,4.0,0.0,D:\BaiduNetdiskDownload\graduation_project\project_folder\ansible\config\manager.py,375.0
ansible.config.manager.ConfigManager.get_plugin_vars,366,3,3,0,3,0,0,8.0,3.0,0.0,D:\BaiduNetdiskDownload\graduation_project\project_folder\ansible\config\manager.py,366.0
ansible.config.manager.ConfigManager.template_default,305,8,4,4,4,0,0,10.0,3.0,0.0,D:\BaiduNetdiskDownload\graduation_project\project_folder\ansible\config\manager.py,305.0
ansible.config.manager._add_base_defs_deprecations,263,2,1,1,1,0,0,12.0,1.0,2.0,D:\BaiduNetdiskDownload\graduation_project\project_folder\ansible\config\manager.py,263.0
ansible.config.manager._get_entry,33,1,0,1,0,0,0,9.0,3.0,0.0,D:\BaiduNetdiskDownload\graduation_project\project_folder\ansible\config\manager.py,33.0
ansible.config.manager.ensure_type,45,11,9,2,9,0,0,114.0,2.0,0.0,D:\BaiduNetdiskDownload\graduation_project\project_folder\ansible\config\manager.py,45.0
ansible.config.manager.find_ini_config_file,198,6,5,1,5,0,0,63.0,0.0,0.0,D:\BaiduNetdiskDownload\graduation_project\project_folder\ansible\config\manager.py,198.0
ansible.config.manager.get_config_type,171,2,0,2,0,0,0,13.0,1.0,0.0,D:\BaiduNetdiskDownload\graduation_project\project_folder\ansible\config\manager.py,171.0
ansible.config.manager.get_ini_config_value,187,1,0,1,0,0,0,9.0,2.0,0.0,D:\BaiduNetdiskDownload\graduation_project\project_folder\ansible\config\manager.py,187.0
ansible.config.manager.resolve_path,162,3,2,1,2,0,0,6.0,1.0,0.0,D:\BaiduNetdiskDownload\graduation_project\project_folder\ansible\config\manager.py,162.0
ansible.constants._DeprecatedSequenceConstant.__getitem__,54,1,1,0,1,0,0,3.0,2.0,0.0,D:\BaiduNetdiskDownload\graduation_project\project_folder\ansible\constants.py,54.0
ansible.constants._DeprecatedSequenceConstant.__len__,50,1,1,0,1,0,0,3.0,1.0,0.0,D:\BaiduNetdiskDownload\graduation_project\project_folder\ansible\constants.py,50.0
ansible.constants._deprecated,29,4,2,2,2,0,0,8.0,2.0,0.0,D:\BaiduNetdiskDownload\graduation_project\project_folder\ansible\constants.py,29.0
ansible.constants._warning,19,3,2,1,2,0,0,8.0,1.0,0.0,D:\BaiduNetdiskDownload\graduation_project\project_folder\ansible\constants.py,19.0
ansible.constants.set_constant,39,1,0,1,0,0,0,3.0,2.0,0.0,D:\BaiduNetdiskDownload\graduation_project\project_folder\ansible\constants.py,39.0
ansible.context._init_global_context,30,1,1,0,1,0,0,4.0,1.0,0.0,D:\BaiduNetdiskDownload\graduation_project\project_folder\ansible\context.py,30.0
ansible.context.cliargs_deferred_get,36,1,1,0,1,0,0,19.0,1.0,2.0,D:\BaiduNetdiskDownload\graduation_project\project_folder\ansible\context.py,36.0
ansible.errors.__init__.AnsibleActionFail.__init__,339,14,0,14,0,0,0,4.0,1.0,0.0,D:\BaiduNetdiskDownload\graduation_project\project_folder\ansible\errors\__init__.py,339.0
ansible.errors.__init__.AnsibleActionSkip.__init__,331,4,0,4,0,0,0,4.0,1.0,0.0,D:\BaiduNetdiskDownload\graduation_project\project_folder\ansible\errors\__init__.py,331.0
ansible.errors.__init__.AnsibleError.__init__,53,257,0,257,0,0,0,8.0,1.0,0.0,D:\BaiduNetdiskDownload\graduation_project\project_folder\ansible\errors\__init__.py,53.0
ansible.errors.__init__.AnsibleError._get_error_lines_from_file,90,2,1,1,1,0,0,32.0,3.0,0.0,D:\BaiduNetdiskDownload\graduation_project\project_folder\ansible\errors\__init__.py,90.0
ansible.errors.__init__.AnsibleError._get_extended_error,123,10,9,1,9,0,0,87.0,1.0,0.0,D:\BaiduNetdiskDownload\graduation_project\project_folder\ansible\errors\__init__.py,123.0
ansible.errors.__init__.AnsibleError.message,63,3,3,0,3,0,0,2.0,2.0,0.0,D:\BaiduNetdiskDownload\graduation_project\project_folder\ansible\errors\__init__.py,63.0
ansible.errors.__init__.AnsibleFileNotFound.__init__,288,12,2,10,2,0,0,22.0,1.0,0.0,D:\BaiduNetdiskDownload\graduation_project\project_folder\ansible\errors\__init__.py,288.0
ansible.executor.discovery.python_target.get_platform_info,24,2,1,1,1,0,0,14.0,1.0,0.0,D:\BaiduNetdiskDownload\graduation_project\project_folder\ansible\executor\discovery\python_target.py,24.0
ansible.executor.discovery.python_target.main,40,2,1,1,1,0,0,4.0,1.0,0.0,D:\BaiduNetdiskDownload\graduation_project\project_folder\ansible\executor\discovery\python_target.py,40.0
ansible.executor.discovery.python_target.read_utf8_file,15,2,1,1,1,0,0,7.0,1.0,0.0,D:\BaiduNetdiskDownload\graduation_project\project_folder\ansible\executor\discovery\python_target.py,15.0
ansible.executor.interpreter_discovery.InterpreterDiscoveryRequiredError.__init__,28,1,0,1,0,0,0,4.0,4.0,0.0,D:\BaiduNetdiskDownload\graduation_project\project_folder\ansible\executor\interpreter_discovery.py,28.0
ansible.executor.interpreter_discovery._get_linux_distro,171,1,0,1,0,0,0,14.0,1.0,0.0,D:\BaiduNetdiskDownload\graduation_project\project_folder\ansible\executor\interpreter_discovery.py,171.0
ansible.executor.interpreter_discovery._version_fuzzy_match,187,2,1,1,1,0,0,22.0,2.0,0.0,D:\BaiduNetdiskDownload\graduation_project\project_folder\ansible\executor\interpreter_discovery.py,187.0
ansible.executor.interpreter_discovery.discover_interpreter,41,19,18,1,18,0,0,128.0,4.0,0.0,D:\BaiduNetdiskDownload\graduation_project\project_folder\ansible\executor\interpreter_discovery.py,41.0
ansible.executor.module_common.CollectionModuleUtilLocator.__init__,817,4,3,1,3,0,0,12.0,2.0,0.0,D:\BaiduNetdiskDownload\graduation_project\project_folder\ansible\executor\module_common.py,817.0
ansible.executor.module_common.CollectionModuleUtilLocator._find_module,830,1,1,0,1,0,0,37.0,2.0,0.0,D:\BaiduNetdiskDownload\graduation_project\project_folder\ansible\executor\module_common.py,830.0
ansible.executor.module_common.LegacyModuleUtilLocator.__init__,775,3,2,1,2,0,0,15.0,2.0,0.0,D:\BaiduNetdiskDownload\graduation_project\project_folder\ansible\executor\module_common.py,775.0
ansible.executor.module_common.LegacyModuleUtilLocator._find_module,794,4,4,0,4,0,0,20.0,2.0,0.0,D:\BaiduNetdiskDownload\graduation_project\project_folder\ansible\executor\module_common.py,794.0
ansible.executor.module_common.LegacyModuleUtilLocator._get_module_utils_remainder_parts,791,1,0,1,0,0,0,2.0,2.0,0.0,D:\BaiduNetdiskDownload\graduation_project\project_folder\ansible\executor\module_common.py,791.0
ansible.executor.module_common.ModuleDepFinder.__init__,438,1,0,1,0,0,0,36.0,5.0,0.0,D:\BaiduNetdiskDownload\graduation_project\project_folder\ansible\executor\module_common.py,438.0
ansible.executor.module_common.ModuleDepFinder.generic_visit,475,2,0,2,0,0,0,15.0,2.0,0.0,D:\BaiduNetdiskDownload\graduation_project\project_folder\ansible\executor\module_common.py,475.0
ansible.executor.module_common.ModuleDepFinder.visit_Import,493,4,4,0,4,0,0,16.0,2.0,0.0,D:\BaiduNetdiskDownload\graduation_project\project_folder\ansible\executor\module_common.py,493.0
ansible.executor.module_common.ModuleDepFinder.visit_ImportFrom,510,6,6,0,6,0,0,64.0,2.0,0.0,D:\BaiduNetdiskDownload\graduation_project\project_folder\ansible\executor\module_common.py,510.0
ansible.executor.module_common.ModuleUtilLocatorBase.__init__,642,1,1,0,1,0,0,20.0,2.0,0.0,D:\BaiduNetdiskDownload\graduation_project\project_folder\ansible\executor\module_common.py,642.0
ansible.executor.module_common.ModuleUtilLocatorBase._find_module,734,1,0,1,0,0,0,2.0,2.0,0.0,D:\BaiduNetdiskDownload\graduation_project\project_folder\ansible\executor\module_common.py,734.0
ansible.executor.module_common.ModuleUtilLocatorBase._generate_redirect_shim_source,763,2,1,1,1,0,0,7.0,3.0,0.0,D:\BaiduNetdiskDownload\graduation_project\project_folder\ansible\executor\module_common.py,763.0
ansible.executor.module_common.ModuleUtilLocatorBase._get_module_utils_remainder,730,2,2,0,2,0,0,3.0,2.0,0.0,D:\BaiduNetdiskDownload\graduation_project\project_folder\ansible\executor\module_common.py,726.0
ansible.executor.module_common.ModuleUtilLocatorBase._get_module_utils_remainder_parts,726,3,0,3,0,0,0,3.0,2.0,0.0,D:\BaiduNetdiskDownload\graduation_project\project_folder\ansible\executor\module_common.py,726.0
ansible.executor.module_common.ModuleUtilLocatorBase._handle_redirect,667,12,11,1,11,0,0,58.0,2.0,0.0,D:\BaiduNetdiskDownload\graduation_project\project_folder\ansible\executor\module_common.py,667.0
ansible.executor.module_common.ModuleUtilLocatorBase._locate,737,4,2,2,2,0,0,25.0,1.0,0.0,D:\BaiduNetdiskDownload\graduation_project\project_folder\ansible\executor\module_common.py,737.0
ansible.executor.module_common.ModuleUtilLocatorBase.candidate_names_joined,664,1,1,0,1,0,0,2.0,1.0,0.0,D:\BaiduNetdiskDownload\graduation_project\project_folder\ansible\executor\module_common.py,664.0
ansible.executor.module_common._add_module_to_zip,1037,4,3,1,3,0,0,32.0,4.0,0.0,D:\BaiduNetdiskDownload\graduation_project\project_folder\ansible\executor\module_common.py,1037.0
ansible.executor.module_common._extract_interpreter,1317,6,4,2,4,0,0,21.0,1.0,0.0,D:\BaiduNetdiskDownload\graduation_project\project_folder\ansible\executor\module_common.py,1317.0
ansible.executor.module_common._find_module_utils,1071,19,18,1,18,0,0,244.0,14.0,0.0,D:\BaiduNetdiskDownload\graduation_project\project_folder\ansible\executor\module_common.py,1071.0
ansible.executor.module_common._get_ansible_module_fqn,1004,4,3,1,3,0,0,31.0,1.0,0.0,D:\BaiduNetdiskDownload\graduation_project\project_folder\ansible\executor\module_common.py,1004.0
ansible.executor.module_common._get_shebang,584,7,5,2,5,0,0,55.0,3.0,0.0,D:\BaiduNetdiskDownload\graduation_project\project_folder\ansible\executor\module_common.py,584.0
ansible.executor.module_common._is_binary,998,2,1,1,1,0,0,4.0,1.0,0.0,D:\BaiduNetdiskDownload\graduation_project\project_folder\ansible\executor\module_common.py,998.0
ansible.executor.module_common._make_zinfo,872,2,0,2,0,0,0,8.0,2.0,0.0,D:\BaiduNetdiskDownload\graduation_project\project_folder\ansible\executor\module_common.py,872.0
ansible.executor.module_common._slurp,576,3,2,1,2,0,0,6.0,1.0,0.0,D:\BaiduNetdiskDownload\graduation_project\project_folder\ansible\executor\module_common.py,576.0
ansible.executor.module_common._strip_comments,391,5,5,0,5,0,0,9.0,1.0,0.0,D:\BaiduNetdiskDownload\graduation_project\project_folder\ansible\executor\module_common.py,391.0
ansible.executor.module_common.get_action_args_with_defaults,1398,7,3,4,3,0,0,36.0,4.0,0.0,D:\BaiduNetdiskDownload\graduation_project\project_folder\ansible\executor\module_common.py,1398.0
ansible.executor.module_common.modify_module,1340,10,9,1,9,0,0,56.0,4.0,0.0,D:\BaiduNetdiskDownload\graduation_project\project_folder\ansible\executor\module_common.py,1340.0
ansible.executor.module_common.recursive_finder,882,15,14,1,14,0,0,114.0,4.0,0.0,D:\BaiduNetdiskDownload\graduation_project\project_folder\ansible\executor\module_common.py,882.0
ansible.executor.play_iterator.HostState.__init__,57,4,0,4,0,0,0,21.0,2.0,0.0,D:\BaiduNetdiskDownload\graduation_project\project_folder\ansible\executor\play_iterator.py,57.0
ansible.executor.play_iterator.HostState.copy,120,3,2,1,2,1,1,23.0,1.0,0.0,D:\BaiduNetdiskDownload\graduation_project\project_folder\ansible\executor\play_iterator.py,120.0
ansible.executor.play_iterator.HostState.get_current_block,117,1,0,1,0,0,0,2.0,1.0,0.0,D:\BaiduNetdiskDownload\graduation_project\project_folder\ansible\executor\play_iterator.py,117.0
ansible.executor.play_iterator.PlayIterator.__init__,147,12,11,1,11,0,0,85.0,6.0,0.0,D:\BaiduNetdiskDownload\graduation_project\project_folder\ansible\executor\play_iterator.py,147.0
ansible.executor.play_iterator.PlayIterator._check_failed_state,502,5,1,4,1,1,1,21.0,2.0,0.0,D:\BaiduNetdiskDownload\graduation_project\project_folder\ansible\executor\play_iterator.py,502.0
ansible.executor.play_iterator.PlayIterator._clear_state_errors,531,3,1,2,1,1,1,9.0,2.0,0.0,D:\BaiduNetdiskDownload\graduation_project\project_folder\ansible\executor\play_iterator.py,531.0
ansible.executor.play_iterator.PlayIterator._get_next_task_from_state,262,9,7,2,7,1,1,191.0,3.0,0.0,D:\BaiduNetdiskDownload\graduation_project\project_folder\ansible\executor\play_iterator.py,262.0
ansible.executor.play_iterator.PlayIterator._insert_tasks_into_state,568,3,1,2,1,1,1,36.0,3.0,0.0,D:\BaiduNetdiskDownload\graduation_project\project_folder\ansible\executor\play_iterator.py,568.0
ansible.executor.play_iterator.PlayIterator._set_failed_state,454,4,1,3,1,1,1,31.0,2.0,0.0,D:\BaiduNetdiskDownload\graduation_project\project_folder\ansible\executor\play_iterator.py,454.0
ansible.executor.play_iterator.PlayIterator.add_notification,630,2,1,1,1,0,0,5.0,3.0,0.0,D:\BaiduNetdiskDownload\graduation_project\project_folder\ansible\executor\play_iterator.py,630.0
ansible.executor.play_iterator.PlayIterator.add_tasks,605,5,3,2,3,0,0,2.0,3.0,0.0,D:\BaiduNetdiskDownload\graduation_project\project_folder\ansible\executor\play_iterator.py,605.0
ansible.executor.play_iterator.PlayIterator.clear_host_errors,528,3,2,1,2,0,0,2.0,2.0,0.0,D:\BaiduNetdiskDownload\graduation_project\project_folder\ansible\executor\play_iterator.py,528.0
ansible.executor.play_iterator.PlayIterator.clear_notification,636,1,0,1,0,0,0,2.0,3.0,0.0,D:\BaiduNetdiskDownload\graduation_project\project_folder\ansible\executor\play_iterator.py,636.0
ansible.executor.play_iterator.PlayIterator.get_active_state,541,2,1,1,1,1,1,11.0,2.0,0.0,D:\BaiduNetdiskDownload\graduation_project\project_folder\ansible\executor\play_iterator.py,541.0
ansible.executor.play_iterator.PlayIterator.get_failed_hosts,499,3,2,1,2,0,0,2.0,1.0,0.0,D:\BaiduNetdiskDownload\graduation_project\project_folder\ansible\executor\play_iterator.py,499.0
ansible.executor.play_iterator.PlayIterator.get_host_state,233,7,2,5,2,0,0,8.0,2.0,0.0,D:\BaiduNetdiskDownload\graduation_project\project_folder\ansible\executor\play_iterator.py,233.0
ansible.executor.play_iterator.PlayIterator.get_next_task_for_host,242,9,4,5,4,0,0,19.0,2.0,0.0,D:\BaiduNetdiskDownload\graduation_project\project_folder\ansible\executor\play_iterator.py,242.0
ansible.executor.play_iterator.PlayIterator.get_state_for_host,612,3,0,3,0,0,0,2.0,2.0,0.0,D:\BaiduNetdiskDownload\graduation_project\project_folder\ansible\executor\play_iterator.py,612.0
ansible.executor.play_iterator.PlayIterator.is_any_block_rescuing,553,4,2,2,2,1,1,14.0,2.0,0.0,D:\BaiduNetdiskDownload\graduation_project\project_folder\ansible\executor\play_iterator.py,553.0
ansible.executor.play_iterator.PlayIterator.is_failed,524,2,2,0,2,0,0,3.0,2.0,0.0,D:\BaiduNetdiskDownload\graduation_project\project_folder\ansible\executor\play_iterator.py,524.0
ansible.executor.play_iterator.PlayIterator.mark_host_failed,486,9,5,4,5,0,0,12.0,2.0,0.0,D:\BaiduNetdiskDownload\graduation_project\project_folder\ansible\executor\play_iterator.py,486.0
ansible.executor.play_iterator.PlayIterator.set_run_state_for_host,620,1,0,1,0,0,0,4.0,3.0,0.0,D:\BaiduNetdiskDownload\graduation_project\project_folder\ansible\executor\play_iterator.py,620.0
ansible.executor.play_iterator.PlayIterator.set_state_for_host,615,8,0,8,0,0,0,4.0,3.0,0.0,D:\BaiduNetdiskDownload\graduation_project\project_folder\ansible\executor\play_iterator.py,615.0
ansible.executor.playbook_executor.PlaybookExecutor.__init__,48,3,2,1,2,0,0,27.0,6.0,0.0,D:\BaiduNetdiskDownload\graduation_project\project_folder\ansible\executor\playbook_executor.py,48.0
ansible.executor.playbook_executor.PlaybookExecutor._generate_retry_inventory,318,5,4,1,4,0,0,16.0,3.0,0.0,D:\BaiduNetdiskDownload\graduation_project\project_folder\ansible\executor\playbook_executor.py,318.0
ansible.executor.playbook_executor.PlaybookExecutor._get_serialized_batches,272,4,3,1,3,0,0,45.0,2.0,0.0,D:\BaiduNetdiskDownload\graduation_project\project_folder\ansible\executor\playbook_executor.py,272.0
ansible.executor.playbook_executor.PlaybookExecutor.run,76,24,22,2,22,1,1,195.0,1.0,0.0,D:\BaiduNetdiskDownload\graduation_project\project_folder\ansible\executor\playbook_executor.py,76.0
ansible.executor.powershell.module_manifest.PSModuleDepFinder.__init__,26,2,1,1,1,0,0,51.0,1.0,0.0,D:\BaiduNetdiskDownload\graduation_project\project_folder\ansible\executor\powershell\module_manifest.py,26.0
ansible.executor.powershell.module_manifest.PSModuleDepFinder._add_module,163,10,8,2,8,0,2,72.0,5.0,0.0,D:\BaiduNetdiskDownload\graduation_project\project_folder\ansible\executor\powershell\module_manifest.py,163.0
ansible.executor.powershell.module_manifest.PSModuleDepFinder._parse_version_match,236,4,3,1,3,0,0,15.0,3.0,0.0,D:\BaiduNetdiskDownload\graduation_project\project_folder\ansible\executor\powershell\module_manifest.py,236.0
ansible.executor.powershell.module_manifest.PSModuleDepFinder.scan_exec_script,141,7,5,2,5,0,2,21.0,2.0,0.0,D:\BaiduNetdiskDownload\graduation_project\project_folder\ansible\executor\powershell\module_manifest.py,141.0
ansible.executor.powershell.module_manifest.PSModuleDepFinder.scan_module,78,11,8,3,8,0,2,62.0,2.0,0.0,D:\BaiduNetdiskDownload\graduation_project\project_folder\ansible\executor\powershell\module_manifest.py,78.0
ansible.executor.powershell.module_manifest._create_powershell_wrapper,285,9,9,0,9,0,0,117.0,13.0,0.0,D:\BaiduNetdiskDownload\graduation_project\project_folder\ansible\executor\powershell\module_manifest.py,285.0
ansible.executor.powershell.module_manifest._slurp,253,3,2,1,2,0,0,8.0,1.0,0.0,D:\BaiduNetdiskDownload\graduation_project\project_folder\ansible\executor\powershell\module_manifest.py,253.0
ansible.executor.powershell.module_manifest._strip_comments,263,7,6,1,6,0,0,20.0,1.0,0.0,D:\BaiduNetdiskDownload\graduation_project\project_folder\ansible\executor\powershell\module_manifest.py,263.0
ansible.executor.process.worker.WorkerProcess.__init__,56,1,0,1,0,0,0,19.0,10.0,0.0,D:\BaiduNetdiskDownload\graduation_project\project_folder\ansible\executor\process\worker.py,56.0
ansible.executor.process.worker.WorkerProcess._clean_up,255,2,1,1,1,0,0,4.0,1.0,0.0,D:\BaiduNetdiskDownload\graduation_project\project_folder\ansible\executor\process\worker.py,255.0
ansible.executor.process.worker.WorkerProcess._hard_exit,110,3,2,1,2,0,0,17.0,2.0,0.0,D:\BaiduNetdiskDownload\graduation_project\project_folder\ansible\executor\process\worker.py,110.0
ansible.executor.process.worker.WorkerProcess._run,157,8,7,1,7,0,0,89.0,1.0,0.0,D:\BaiduNetdiskDownload\graduation_project\project_folder\ansible\executor\process\worker.py,157.0
ansible.executor.process.worker.WorkerProcess._save_stdin,76,1,0,1,0,0,0,16.0,1.0,0.0,D:\BaiduNetdiskDownload\graduation_project\project_folder\ansible\executor\process\worker.py,76.0
ansible.executor.process.worker.WorkerProcess.run,128,2,2,0,2,0,0,28.0,1.0,0.0,D:\BaiduNetdiskDownload\graduation_project\project_folder\ansible\executor\process\worker.py,128.0
ansible.executor.process.worker.WorkerProcess.start,93,2,1,1,1,0,0,16.0,1.0,0.0,D:\BaiduNetdiskDownload\graduation_project\project_folder\ansible\executor\process\worker.py,93.0
ansible.executor.stats.AggregateStats.__init__,28,1,0,1,0,0,0,13.0,1.0,0.0,D:\BaiduNetdiskDownload\graduation_project\project_folder\ansible\executor\stats.py,28.0
ansible.executor.stats.AggregateStats.decrement,49,1,0,1,0,0,0,9.0,3.0,0.0,D:\BaiduNetdiskDownload\graduation_project\project_folder\ansible\executor\stats.py,49.0
ansible.executor.stats.AggregateStats.increment,42,4,0,4,0,0,0,6.0,3.0,0.0,D:\BaiduNetdiskDownload\graduation_project\project_folder\ansible\executor\stats.py,42.0
ansible.executor.stats.AggregateStats.set_custom_stats,72,2,0,2,0,0,0,9.0,3.0,0.0,D:\BaiduNetdiskDownload\graduation_project\project_folder\ansible\executor\stats.py,72.0
ansible.executor.stats.AggregateStats.summarize,59,1,0,1,0,0,0,12.0,2.0,0.0,D:\BaiduNetdiskDownload\graduation_project\project_folder\ansible\executor\stats.py,59.0
ansible.executor.stats.AggregateStats.update_custom_stats,82,3,2,1,2,0,0,17.0,3.0,0.0,D:\BaiduNetdiskDownload\graduation_project\project_folder\ansible\executor\stats.py,82.0
ansible.executor.task_executor.TaskExecutor.__init__,84,2,1,1,1,0,0,14.0,10.0,0.0,D:\BaiduNetdiskDownload\graduation_project\project_folder\ansible\executor\task_executor.py,84.0
ansible.executor.task_executor.TaskExecutor._calculate_delegate_to,406,2,1,1,1,0,0,11.0,3.0,0.0,D:\BaiduNetdiskDownload\graduation_project\project_folder\ansible\executor\task_executor.py,406.0
ansible.executor.task_executor.TaskExecutor._execute,418,31,29,2,29,0,3,408.0,1.0,0.0,D:\BaiduNetdiskDownload\graduation_project\project_folder\ansible\executor\task_executor.py,418.0
ansible.executor.task_executor.TaskExecutor._get_action_handler,1103,2,1,1,1,0,0,5.0,2.0,0.0,D:\BaiduNetdiskDownload\graduation_project\project_folder\ansible\executor\task_executor.py,1103.0
ansible.executor.task_executor.TaskExecutor._get_action_handler_with_module_context,1109,11,9,2,9,0,0,71.0,2.0,0.0,D:\BaiduNetdiskDownload\graduation_project\project_folder\ansible\executor\task_executor.py,1109.0
ansible.executor.task_executor.TaskExecutor._get_become,938,2,1,1,1,0,0,6.0,2.0,0.0,D:\BaiduNetdiskDownload\graduation_project\project_folder\ansible\executor\task_executor.py,938.0
ansible.executor.task_executor.TaskExecutor._get_connection,945,6,4,2,4,0,0,30.0,4.0,0.0,D:\BaiduNetdiskDownload\graduation_project\project_folder\ansible\executor\task_executor.py,945.0
ansible.executor.task_executor.TaskExecutor._get_loop_items,209,8,7,1,7,0,0,47.0,1.0,0.0,D:\BaiduNetdiskDownload\graduation_project\project_folder\ansible\executor\task_executor.py,209.0
ansible.executor.task_executor.TaskExecutor._poll_async_result,827,7,6,1,6,0,0,110.0,3.0,0.0,D:\BaiduNetdiskDownload\graduation_project\project_folder\ansible\executor\task_executor.py,827.0
ansible.executor.task_executor.TaskExecutor._run_loop,257,13,12,1,12,0,3,148.0,2.0,0.0,D:\BaiduNetdiskDownload\graduation_project\project_folder\ansible\executor\task_executor.py,257.0
ansible.executor.task_executor.TaskExecutor._set_become_plugin,976,5,3,2,3,0,0,35.0,4.0,0.0,D:\BaiduNetdiskDownload\graduation_project\project_folder\ansible\executor\task_executor.py,976.0
ansible.executor.task_executor.TaskExecutor._set_connection_options,1033,6,5,1,5,0,0,69.0,3.0,0.0,D:\BaiduNetdiskDownload\graduation_project\project_folder\ansible\executor\task_executor.py,1033.0
ansible.executor.task_executor.TaskExecutor._set_plugin_options,1012,1,0,1,0,0,0,20.0,5.0,0.0,D:\BaiduNetdiskDownload\graduation_project\project_folder\ansible\executor\task_executor.py,1012.0
ansible.executor.task_executor.TaskExecutor.run,99,10,9,1,9,0,3,109.0,1.0,0.0,D:\BaiduNetdiskDownload\graduation_project\project_folder\ansible\executor\task_executor.py,99.0
ansible.executor.task_executor.remove_omit,52,5,2,3,2,1,1,21.0,2.0,0.0,D:\BaiduNetdiskDownload\graduation_project\project_folder\ansible\executor\task_executor.py,52.0
ansible.executor.task_executor.start_connection,1185,7,6,1,6,0,0,64.0,3.0,0.0,D:\BaiduNetdiskDownload\graduation_project\project_folder\ansible\executor\task_executor.py,1185.0
ansible.executor.task_queue_manager.AnsibleEndPlay.__init__,109,1,0,1,0,0,0,2.0,2.0,0.0,D:\BaiduNetdiskDownload\graduation_project\project_folder\ansible\executor\task_queue_manager.py,109.0
ansible.executor.task_queue_manager.CallbackSend.__init__,55,1,0,1,0,0,0,4.0,4.0,0.0,D:\BaiduNetdiskDownload\graduation_project\project_folder\ansible\executor\task_queue_manager.py,55.0
ansible.executor.task_queue_manager.DisplaySend.__init__,62,1,0,1,0,0,0,4.0,4.0,0.0,D:\BaiduNetdiskDownload\graduation_project\project_folder\ansible\executor\task_queue_manager.py,62.0
ansible.executor.task_queue_manager.FinalQueue.__init__,79,1,0,1,0,0,0,3.0,3.0,0.0,D:\BaiduNetdiskDownload\graduation_project\project_folder\ansible\executor\task_queue_manager.py,79.0
ansible.executor.task_queue_manager.FinalQueue.send_callback,83,2,2,0,2,0,0,4.0,4.0,0.0,D:\BaiduNetdiskDownload\graduation_project\project_folder\ansible\executor\task_queue_manager.py,83.0
ansible.executor.task_queue_manager.FinalQueue.send_display,97,3,2,1,2,0,0,4.0,4.0,0.0,D:\BaiduNetdiskDownload\graduation_project\project_folder\ansible\executor\task_queue_manager.py,97.0
ansible.executor.task_queue_manager.FinalQueue.send_prompt,102,2,1,1,1,0,0,4.0,2.0,0.0,D:\BaiduNetdiskDownload\graduation_project\project_folder\ansible\executor\task_queue_manager.py,102.0
ansible.executor.task_queue_manager.FinalQueue.send_task_result,88,3,2,1,2,0,0,8.0,3.0,0.0,D:\BaiduNetdiskDownload\graduation_project\project_folder\ansible\executor\task_queue_manager.py,88.0
ansible.executor.task_queue_manager.TaskQueueManager.__init__,132,6,3,3,3,0,0,39.0,5.0,0.0,D:\BaiduNetdiskDownload\graduation_project\project_folder\ansible\executor\task_queue_manager.py,132.0
ansible.executor.task_queue_manager.TaskQueueManager._cleanup_processes,370,4,2,2,2,0,0,17.0,1.0,0.0,D:\BaiduNetdiskDownload\graduation_project\project_folder\ansible\executor\task_queue_manager.py,370.0
ansible.executor.task_queue_manager.TaskQueueManager._initialize_processes,172,2,1,1,1,0,0,5.0,2.0,0.0,D:\BaiduNetdiskDownload\graduation_project\project_folder\ansible\executor\task_queue_manager.py,172.0
ansible.executor.task_queue_manager.TaskQueueManager.cleanup,360,3,3,0,3,0,0,9.0,1.0,0.0,D:\BaiduNetdiskDownload\graduation_project\project_folder\ansible\executor\task_queue_manager.py,360.0
ansible.executor.task_queue_manager.TaskQueueManager.clear_failed_hosts,388,2,0,2,0,0,0,2.0,1.0,0.0,D:\BaiduNetdiskDownload\graduation_project\project_folder\ansible\executor\task_queue_manager.py,388.0
ansible.executor.task_queue_manager.TaskQueueManager.get_inventory,391,1,0,1,0,0,0,2.0,1.0,0.0,D:\BaiduNetdiskDownload\graduation_project\project_folder\ansible\executor\task_queue_manager.py,391.0
ansible.executor.task_queue_manager.TaskQueueManager.has_dead_workers,406,1,0,1,0,0,0,10.0,1.0,0.0,D:\BaiduNetdiskDownload\graduation_project\project_folder\ansible\executor\task_queue_manager.py,406.0
ansible.executor.task_queue_manager.TaskQueueManager.load_callbacks,178,8,5,3,5,0,0,92.0,1.0,0.0,D:\BaiduNetdiskDownload\graduation_project\project_folder\ansible\executor\task_queue_manager.py,178.0
ansible.executor.task_queue_manager.TaskQueueManager.run,271,17,17,0,17,0,0,88.0,2.0,0.0,D:\BaiduNetdiskDownload\graduation_project\project_folder\ansible\executor\task_queue_manager.py,271.0
ansible.executor.task_queue_manager.TaskQueueManager.send_callback,418,7,6,1,6,0,0,52.0,4.0,0.0,D:\BaiduNetdiskDownload\graduation_project\project_folder\ansible\executor\task_queue_manager.py,418.0
ansible.executor.task_queue_manager.TaskQueueManager.terminate,403,4,0,4,0,0,0,2.0,1.0,0.0,D:\BaiduNetdiskDownload\graduation_project\project_folder\ansible\executor\task_queue_manager.py,403.0
ansible.executor.task_result.TaskResult.__init__,31,9,1,8,1,0,0,13.0,4.0,0.0,D:\BaiduNetdiskDownload\graduation_project\project_folder\ansible\executor\task_result.py,31.0
ansible.executor.task_result.TaskResult._check_key,95,3,0,3,0,0,0,11.0,2.0,0.0,D:\BaiduNetdiskDownload\graduation_project\project_folder\ansible\executor\task_result.py,95.0
ansible.executor.task_result.TaskResult.clean_copy,107,4,3,1,3,0,0,47.0,1.0,0.0,D:\BaiduNetdiskDownload\graduation_project\project_folder\ansible\executor\task_result.py,107.0
ansible.executor.task_result.TaskResult.is_changed,49,2,1,1,1,0,0,2.0,1.0,0.0,D:\BaiduNetdiskDownload\graduation_project\project_folder\ansible\executor\task_result.py,49.0
ansible.executor.task_result.TaskResult.is_failed,64,3,1,2,1,0,0,6.0,1.0,0.0,D:\BaiduNetdiskDownload\graduation_project\project_folder\ansible\executor\task_result.py,64.0
ansible.executor.task_result.TaskResult.is_skipped,52,2,0,2,0,0,0,11.0,1.0,0.0,D:\BaiduNetdiskDownload\graduation_project\project_folder\ansible\executor\task_result.py,52.0
ansible.executor.task_result.TaskResult.is_unreachable,71,5,1,4,1,0,0,2.0,1.0,0.0,D:\BaiduNetdiskDownload\graduation_project\project_folder\ansible\executor\task_result.py,71.0
ansible.executor.task_result.TaskResult.needs_debugger,74,4,3,1,3,0,0,20.0,1.0,0.0,D:\BaiduNetdiskDownload\graduation_project\project_folder\ansible\executor\task_result.py,74.0
ansible.galaxy.__init__.Galaxy.__init__,45,1,0,1,0,0,0,17.0,1.0,0.0,D:\BaiduNetdiskDownload\graduation_project\project_folder\ansible\galaxy\__init__.py,45.0
ansible.galaxy.__init__.get_collections_galaxy_meta_info,36,3,1,2,1,0,0,4.0,1.0,0.0,D:\BaiduNetdiskDownload\graduation_project\project_folder\ansible\galaxy\__init__.py,36.0
ansible.galaxy.api.CollectionVersionMetadata.__init__,250,1,0,1,0,0,0,22.0,9.0,0.0,D:\BaiduNetdiskDownload\graduation_project\project_folder\ansible\galaxy\api.py,250.0
ansible.galaxy.api.GalaxyAPI.__init__,278,8,6,2,6,0,0,35.0,4.0,0.0,D:\BaiduNetdiskDownload\graduation_project\project_folder\ansible\galaxy\api.py,278.0
ansible.galaxy.api.GalaxyAPI.__repr__,324,1,1,0,1,0,0,10.0,1.0,0.0,D:\BaiduNetdiskDownload\graduation_project\project_folder\ansible\galaxy\api.py,324.0
ansible.galaxy.api.GalaxyAPI.__unicode__,319,1,1,0,1,0,0,4.0,1.0,0.0,D:\BaiduNetdiskDownload\graduation_project\project_folder\ansible\galaxy\api.py,319.0
ansible.galaxy.api.GalaxyAPI._add_auth_token,446,3,2,1,2,0,0,11.0,3.0,0.0,D:\BaiduNetdiskDownload\graduation_project\project_folder\ansible\galaxy\api.py,446.0
ansible.galaxy.api.GalaxyAPI._call_galaxy,356,29,12,17,12,0,0,89.0,2.0,0.0,D:\BaiduNetdiskDownload\graduation_project\project_folder\ansible\galaxy\api.py,356.0
ansible.galaxy.api.GalaxyAPI._set_cache,459,5,2,3,2,0,0,3.0,1.0,0.0,D:\BaiduNetdiskDownload\graduation_project\project_folder\ansible\galaxy\api.py,459.0
ansible.galaxy.api.GalaxyAPI.add_secret,623,3,2,1,2,0,0,10.0,5.0,0.0,D:\BaiduNetdiskDownload\graduation_project\project_folder\ansible\galaxy\api.py,623.0
ansible.galaxy.api.GalaxyAPI.authenticate,464,7,7,0,7,0,0,16.0,2.0,0.0,D:\BaiduNetdiskDownload\graduation_project\project_folder\ansible\galaxy\api.py,464.0
ansible.galaxy.api.GalaxyAPI.create_import_task,482,3,2,1,2,0,0,16.0,3.0,0.0,D:\BaiduNetdiskDownload\graduation_project\project_folder\ansible\galaxy\api.py,482.0
ansible.galaxy.api.GalaxyAPI.delete_role,647,3,2,1,2,0,0,5.0,3.0,0.0,D:\BaiduNetdiskDownload\graduation_project\project_folder\ansible\galaxy\api.py,647.0
ansible.galaxy.api.GalaxyAPI.fetch_role_related,539,5,4,1,4,0,0,28.0,3.0,0.0,D:\BaiduNetdiskDownload\graduation_project\project_folder\ansible\galaxy\api.py,539.0
ansible.galaxy.api.GalaxyAPI.get_collection_metadata,768,3,2,1,2,0,0,31.0,3.0,0.0,D:\BaiduNetdiskDownload\graduation_project\project_folder\ansible\galaxy\api.py,768.0
ansible.galaxy.api.GalaxyAPI.get_collection_signatures,914,6,4,2,4,0,0,22.0,4.0,0.0,D:\BaiduNetdiskDownload\graduation_project\project_folder\ansible\galaxy\api.py,914.0
ansible.galaxy.api.GalaxyAPI.get_collection_version_metadata,801,4,4,0,4,0,0,23.0,4.0,0.0,D:\BaiduNetdiskDownload\graduation_project\project_folder\ansible\galaxy\api.py,801.0
ansible.galaxy.api.GalaxyAPI.get_collection_versions,826,6,6,0,6,0,0,86.0,3.0,0.0,D:\BaiduNetdiskDownload\graduation_project\project_folder\ansible\galaxy\api.py,826.0
ansible.galaxy.api.GalaxyAPI.get_import_task,500,4,3,1,3,0,0,14.0,1.0,0.0,D:\BaiduNetdiskDownload\graduation_project\project_folder\ansible\galaxy\api.py,500.0
ansible.galaxy.api.GalaxyAPI.get_list,569,3,3,0,3,0,0,22.0,2.0,0.0,D:\BaiduNetdiskDownload\graduation_project\project_folder\ansible\galaxy\api.py,569.0
ansible.galaxy.api.GalaxyAPI.list_secrets,635,3,2,1,2,0,0,4.0,1.0,0.0,D:\BaiduNetdiskDownload\graduation_project\project_folder\ansible\galaxy\api.py,635.0
ansible.galaxy.api.GalaxyAPI.lookup_role_by_name,516,10,8,2,8,0,0,21.0,2.0,0.0,D:\BaiduNetdiskDownload\graduation_project\project_folder\ansible\galaxy\api.py,516.0
ansible.galaxy.api.GalaxyAPI.publish_collection,656,9,8,1,8,0,0,44.0,2.0,0.0,D:\BaiduNetdiskDownload\graduation_project\project_folder\ansible\galaxy\api.py,656.0
ansible.galaxy.api.GalaxyAPI.remove_secret,641,3,2,1,2,0,0,4.0,2.0,0.0,D:\BaiduNetdiskDownload\graduation_project\project_folder\ansible\galaxy\api.py,641.0
ansible.galaxy.api.GalaxyAPI.search_roles,593,7,6,1,6,0,0,28.0,3.0,0.0,D:\BaiduNetdiskDownload\graduation_project\project_folder\ansible\galaxy\api.py,593.0
ansible.galaxy.api.GalaxyAPI.wait_import_task,702,9,8,1,8,0,0,64.0,2.0,0.0,D:\BaiduNetdiskDownload\graduation_project\project_folder\ansible\galaxy\api.py,702.0
ansible.galaxy.api.GalaxyError.__init__,206,7,5,2,5,0,0,35.0,3.0,0.0,D:\BaiduNetdiskDownload\graduation_project\project_folder\ansible\galaxy\api.py,206.0
ansible.galaxy.api._load_cache,165,7,6,1,6,0,0,32.0,1.0,0.0,D:\BaiduNetdiskDownload\graduation_project\project_folder\ansible\galaxy\api.py,165.0
ansible.galaxy.api._urljoin,199,20,2,18,2,0,0,2.0,1.0,0.0,D:\BaiduNetdiskDownload\graduation_project\project_folder\ansible\galaxy\api.py,199.0
ansible.galaxy.api.g_connect,73,7,7,0,7,0,0,75.0,1.0,3.0,D:\BaiduNetdiskDownload\graduation_project\project_folder\ansible\galaxy\api.py,73.0
ansible.galaxy.api.get_cache_id,150,2,0,2,0,0,0,12.0,1.0,0.0,D:\BaiduNetdiskDownload\graduation_project\project_folder\ansible\galaxy\api.py,150.0
ansible.galaxy.api.should_retry_error,53,1,0,1,0,0,0,18.0,1.0,0.0,D:\BaiduNetdiskDownload\graduation_project\project_folder\ansible\galaxy\api.py,53.0
ansible.galaxy.collection.__init__.CollectionSignatureError.__init__,162,1,0,1,0,0,0,7.0,1.0,0.0,D:\BaiduNetdiskDownload\graduation_project\project_folder\ansible\galaxy\collection\__init__.py,162.0
ansible.galaxy.collection.__init__.CollectionSignatureError._format_reasons,180,2,1,1,1,0,0,13.0,1.0,0.0,D:\BaiduNetdiskDownload\graduation_project\project_folder\ansible\galaxy\collection\__init__.py,180.0
ansible.galaxy.collection.__init__.CollectionSignatureError._report_expected,176,2,1,1,1,0,0,3.0,2.0,0.0,D:\BaiduNetdiskDownload\graduation_project\project_folder\ansible\galaxy\collection\__init__.py,176.0
ansible.galaxy.collection.__init__.CollectionSignatureError._report_unexpected,170,1,0,1,0,0,0,5.0,2.0,0.0,D:\BaiduNetdiskDownload\graduation_project\project_folder\ansible\galaxy\collection\__init__.py,170.0
ansible.galaxy.collection.__init__.CollectionSignatureError.report,194,3,2,1,2,0,0,5.0,2.0,0.0,D:\BaiduNetdiskDownload\graduation_project\project_folder\ansible\galaxy\collection\__init__.py,194.0
ansible.galaxy.collection.__init__.CollectionVerifyResult.__init__,203,1,0,1,0,0,0,3.0,2.0,0.0,D:\BaiduNetdiskDownload\graduation_project\project_folder\ansible\galaxy\collection\__init__.py,203.0
ansible.galaxy.collection.__init__.ManifestControl.__post_init__,152,1,1,0,1,0,0,7.0,1.0,0.0,D:\BaiduNetdiskDownload\graduation_project\project_folder\ansible\galaxy\collection\__init__.py,152.0
ansible.galaxy.collection.__init__._build_collection_dir,1372,5,4,1,4,0,0,47.0,4.0,0.0,D:\BaiduNetdiskDownload\graduation_project\project_folder\ansible\galaxy\collection\__init__.py,1372.0
ansible.galaxy.collection.__init__._build_collection_tar,1300,9,8,1,8,0,0,70.0,4.0,0.0,D:\BaiduNetdiskDownload\graduation_project\project_folder\ansible\galaxy\collection\__init__.py,1300.0
ansible.galaxy.collection.__init__._build_files_manifest,1073,5,3,2,3,0,0,16.0,6.0,0.0,D:\BaiduNetdiskDownload\graduation_project\project_folder\ansible\galaxy\collection\__init__.py,1073.0
ansible.galaxy.collection.__init__._build_files_manifest_distlib,1091,13,12,1,12,0,0,101.0,5.0,0.0,D:\BaiduNetdiskDownload\graduation_project\project_folder\ansible\galaxy\collection\__init__.py,1091.0
ansible.galaxy.collection.__init__._build_files_manifest_walk,1194,12,11,1,11,0,0,71.0,4.0,2.0,D:\BaiduNetdiskDownload\graduation_project\project_folder\ansible\galaxy\collection\__init__.py,1194.0
ansible.galaxy.collection.__init__._build_manifest,1268,2,0,2,0,0,0,30.0,14.0,0.0,D:\BaiduNetdiskDownload\graduation_project\project_folder\ansible\galaxy\collection\__init__.py,1268.0
ansible.galaxy.collection.__init__._display_progress,968,7,3,4,3,0,0,65.0,0.0,2.0,D:\BaiduNetdiskDownload\graduation_project\project_folder\ansible\galaxy\collection\__init__.py,968.0
ansible.galaxy.collection.__init__._extract_tar_dir,1672,4,3,1,3,0,0,29.0,3.0,0.0,D:\BaiduNetdiskDownload\graduation_project\project_folder\ansible\galaxy\collection\__init__.py,1672.0
ansible.galaxy.collection.__init__._extract_tar_file,1703,6,5,1,5,0,0,43.0,4.0,0.0,D:\BaiduNetdiskDownload\graduation_project\project_folder\ansible\galaxy\collection\__init__.py,1703.0
ansible.galaxy.collection.__init__._get_file_hash,1780,2,2,0,2,0,0,4.0,2.0,0.0,D:\BaiduNetdiskDownload\graduation_project\project_folder\ansible\galaxy\collection\__init__.py,1780.0
ansible.galaxy.collection.__init__._get_json_from_tar_file,1760,3,3,0,3,0,0,12.0,2.0,0.0,D:\BaiduNetdiskDownload\graduation_project\project_folder\ansible\galaxy\collection\__init__.py,1760.0
ansible.galaxy.collection.__init__._get_tar_file_hash,1774,2,2,0,2,0,0,4.0,2.0,0.0,D:\BaiduNetdiskDownload\graduation_project\project_folder\ansible\galaxy\collection\__init__.py,1774.0
ansible.galaxy.collection.__init__._get_tar_file_member,1748,5,2,3,2,0,0,10.0,2.0,0.0,D:\BaiduNetdiskDownload\graduation_project\project_folder\ansible\galaxy\collection\__init__.py,1748.0
ansible.galaxy.collection.__init__._is_child_path,1786,6,2,4,2,0,0,11.0,2.0,0.0,D:\BaiduNetdiskDownload\graduation_project\project_folder\ansible\galaxy\collection\__init__.py,1786.0
ansible.galaxy.collection.__init__._make_entry,1063,2,0,2,0,0,0,8.0,2.0,0.0,D:\BaiduNetdiskDownload\graduation_project\project_folder\ansible\galaxy\collection\__init__.py,1063.0
ansible.galaxy.collection.__init__._make_manifest,1048,2,0,2,0,0,0,13.0,1.0,0.0,D:\BaiduNetdiskDownload\graduation_project\project_folder\ansible\galaxy\collection\__init__.py,1048.0
ansible.galaxy.collection.__init__._normalize_collection_path,1421,1,0,1,0,0,0,6.0,1.0,0.0,D:\BaiduNetdiskDownload\graduation_project\project_folder\ansible\galaxy\collection\__init__.py,1421.0
ansible.galaxy.collection.__init__._resolve_depenency_map,1799,8,6,2,6,0,0,107.0,9.0,0.0,D:\BaiduNetdiskDownload\graduation_project\project_folder\ansible\galaxy\collection\__init__.py,1799.0
ansible.galaxy.collection.__init__._tempdir,959,2,1,1,1,0,0,6.0,1.0,0.0,D:\BaiduNetdiskDownload\graduation_project\project_folder\ansible\galaxy\collection\__init__.py,959.0
ansible.galaxy.collection.__init__._verify_file_hash,1035,5,4,1,4,0,0,11.0,4.0,0.0,D:\BaiduNetdiskDownload\graduation_project\project_folder\ansible\galaxy\collection\__init__.py,1035.0
ansible.galaxy.collection.__init__.build_collection,465,9,7,2,7,0,0,46.0,3.0,0.0,D:\BaiduNetdiskDownload\graduation_project\project_folder\ansible\galaxy\collection\__init__.py,465.0
ansible.galaxy.collection.__init__.download_collections,513,13,12,1,12,0,0,100.0,6.0,0.0,D:\BaiduNetdiskDownload\graduation_project\project_folder\ansible\galaxy\collection\__init__.py,513.0
ansible.galaxy.collection.__init__.find_existing_collections,1429,14,11,3,11,0,0,65.0,2.0,0.0,D:\BaiduNetdiskDownload\graduation_project\project_folder\ansible\galaxy\collection\__init__.py,1429.0
ansible.galaxy.collection.__init__.install,1496,9,8,1,8,0,0,140.0,13.0,0.0,D:\BaiduNetdiskDownload\graduation_project\project_folder\ansible\galaxy\collection\__init__.py,652.0
ansible.galaxy.collection.__init__.install_artifact,1574,7,6,1,6,0,0,54.0,7.0,0.0,D:\BaiduNetdiskDownload\graduation_project\project_folder\ansible\galaxy\collection\__init__.py,1574.0
ansible.galaxy.collection.__init__.install_collections,652,18,17,1,17,0,0,140.0,13.0,0.0,D:\BaiduNetdiskDownload\graduation_project\project_folder\ansible\galaxy\collection\__init__.py,652.0
ansible.galaxy.collection.__init__.install_src,1630,7,6,1,6,0,0,40.0,4.0,0.0,D:\BaiduNetdiskDownload\graduation_project\project_folder\ansible\galaxy\collection\__init__.py,1630.0
ansible.galaxy.collection.__init__.publish_collection,615,8,7,1,7,0,0,35.0,4.0,0.0,D:\BaiduNetdiskDownload\graduation_project\project_folder\ansible\galaxy\collection\__init__.py,615.0
ansible.galaxy.collection.__init__.validate_collection_name,795,3,2,1,2,0,0,14.0,1.0,0.0,D:\BaiduNetdiskDownload\graduation_project\project_folder\ansible\galaxy\collection\__init__.py,795.0
ansible.galaxy.collection.__init__.validate_collection_path,812,2,0,2,0,0,0,11.0,1.0,0.0,D:\BaiduNetdiskDownload\graduation_project\project_folder\ansible\galaxy\collection\__init__.py,812.0
ansible.galaxy.collection.__init__.verify_artifact_manifest,1564,6,5,1,5,0,0,8.0,5.0,0.0,D:\BaiduNetdiskDownload\graduation_project\project_folder\ansible\galaxy\collection\__init__.py,1564.0
ansible.galaxy.collection.__init__.verify_collections,825,17,16,1,16,0,0,131.0,6.0,0.0,D:\BaiduNetdiskDownload\graduation_project\project_folder\ansible\galaxy\collection\__init__.py,825.0
ansible.galaxy.collection.__init__.verify_file_signature,433,7,6,1,6,0,0,48.0,6.0,0.0,D:\BaiduNetdiskDownload\graduation_project\project_folder\ansible\galaxy\collection\__init__.py,383.0
ansible.galaxy.collection.__init__.verify_file_signatures,383,8,6,2,6,0,0,48.0,6.0,0.0,D:\BaiduNetdiskDownload\graduation_project\project_folder\ansible\galaxy\collection\__init__.py,383.0
ansible.galaxy.collection.__init__.verify_local_collection,208,15,14,1,14,0,0,173.0,3.0,0.0,D:\BaiduNetdiskDownload\graduation_project\project_folder\ansible\galaxy\collection\__init__.py,208.0
ansible.galaxy.collection.__init__.write_source_metadata,1541,6,5,1,5,0,0,21.0,3.0,0.0,D:\BaiduNetdiskDownload\graduation_project\project_folder\ansible\galaxy\collection\__init__.py,1541.0
ansible.galaxy.collection.concrete_artifact_manager.ConcreteArtifactsManager._get_direct_collection_name,263,2,1,1,1,0,0,3.0,2.0,0.0,D:\BaiduNetdiskDownload\graduation_project\project_folder\ansible\galaxy\collection\concrete_artifact_manager.py,259.0
ansible.galaxy.collection.concrete_artifact_manager.ConcreteArtifactsManager._get_direct_collection_namespace,259,2,1,1,1,0,0,3.0,2.0,0.0,D:\BaiduNetdiskDownload\graduation_project\project_folder\ansible\galaxy\collection\concrete_artifact_manager.py,259.0
ansible.galaxy.collection.concrete_artifact_manager.ConcreteArtifactsManager.get_artifact_path,191,8,6,2,6,0,0,61.0,2.0,0.0,D:\BaiduNetdiskDownload\graduation_project\project_folder\ansible\galaxy\collection\concrete_artifact_manager.py,191.0
ansible.galaxy.collection.concrete_artifact_manager.ConcreteArtifactsManager.get_artifact_path_from_unknown,253,5,2,3,2,0,0,5.0,2.0,0.0,D:\BaiduNetdiskDownload\graduation_project\project_folder\ansible\galaxy\collection\concrete_artifact_manager.py,253.0
ansible.galaxy.collection.concrete_artifact_manager.ConcreteArtifactsManager.get_direct_collection_dependencies,288,3,1,2,1,0,0,7.0,2.0,0.0,D:\BaiduNetdiskDownload\graduation_project\project_folder\ansible\galaxy\collection\concrete_artifact_manager.py,288.0
ansible.galaxy.collection.concrete_artifact_manager.ConcreteArtifactsManager.get_direct_collection_fqcn,267,5,3,2,3,0,0,15.0,2.0,0.0,D:\BaiduNetdiskDownload\graduation_project\project_folder\ansible\galaxy\collection\concrete_artifact_manager.py,267.0
ansible.galaxy.collection.concrete_artifact_manager.ConcreteArtifactsManager.get_direct_collection_meta,296,10,5,5,5,0,0,42.0,2.0,0.0,D:\BaiduNetdiskDownload\graduation_project\project_folder\ansible\galaxy\collection\concrete_artifact_manager.py,296.0
ansible.galaxy.collection.concrete_artifact_manager.ConcreteArtifactsManager.get_direct_collection_version,283,4,1,3,1,0,0,4.0,2.0,0.0,D:\BaiduNetdiskDownload\graduation_project\project_folder\ansible\galaxy\collection\concrete_artifact_manager.py,283.0
ansible.galaxy.collection.concrete_artifact_manager.ConcreteArtifactsManager.get_galaxy_artifact_path,127,6,5,1,5,0,0,63.0,2.0,0.0,D:\BaiduNetdiskDownload\graduation_project\project_folder\ansible\galaxy\collection\concrete_artifact_manager.py,127.0
ansible.galaxy.collection.concrete_artifact_manager.ConcreteArtifactsManager.get_galaxy_artifact_source_info,103,2,1,1,1,0,0,23.0,2.0,0.0,D:\BaiduNetdiskDownload\graduation_project\project_folder\ansible\galaxy\collection\concrete_artifact_manager.py,103.0
ansible.galaxy.collection.concrete_artifact_manager.ConcreteArtifactsManager.save_collection_source,339,1,0,1,0,0,0,9.0,7.0,0.0,D:\BaiduNetdiskDownload\graduation_project\project_folder\ansible\galaxy\collection\concrete_artifact_manager.py,339.0
ansible.galaxy.collection.concrete_artifact_manager.ConcreteArtifactsManager.under_tmpdir,351,2,1,1,1,0,0,31.0,2.0,0.0,D:\BaiduNetdiskDownload\graduation_project\project_folder\ansible\galaxy\collection\concrete_artifact_manager.py,351.0
ansible.galaxy.collection.concrete_artifact_manager._consume_file,509,7,2,5,2,0,0,13.0,1.0,0.0,D:\BaiduNetdiskDownload\graduation_project\project_folder\ansible\galaxy\collection\concrete_artifact_manager.py,509.0
ansible.galaxy.collection.concrete_artifact_manager._download_file,465,13,11,2,11,0,0,42.0,4.0,0.0,D:\BaiduNetdiskDownload\graduation_project\project_folder\ansible\galaxy\collection\concrete_artifact_manager.py,465.0
ansible.galaxy.collection.concrete_artifact_manager._extract_collection_from_git,411,7,6,1,6,0,0,47.0,3.0,0.0,D:\BaiduNetdiskDownload\graduation_project\project_folder\ansible\galaxy\collection\concrete_artifact_manager.py,411.0
ansible.galaxy.collection.concrete_artifact_manager._get_json_from_installed_dir,647,6,5,1,5,0,0,31.0,2.0,0.0,D:\BaiduNetdiskDownload\graduation_project\project_folder\ansible\galaxy\collection\concrete_artifact_manager.py,647.0
ansible.galaxy.collection.concrete_artifact_manager._get_meta_from_dir,603,3,2,1,2,0,0,8.0,1.0,0.0,D:\BaiduNetdiskDownload\graduation_project\project_folder\ansible\galaxy\collection\concrete_artifact_manager.py,603.0
ansible.galaxy.collection.concrete_artifact_manager._get_meta_from_installed_dir,680,5,4,1,4,0,0,19.0,1.0,0.0,D:\BaiduNetdiskDownload\graduation_project\project_folder\ansible\galaxy\collection\concrete_artifact_manager.py,680.0
ansible.galaxy.collection.concrete_artifact_manager._get_meta_from_src_dir,613,6,4,2,4,0,0,32.0,1.0,0.0,D:\BaiduNetdiskDownload\graduation_project\project_folder\ansible\galaxy\collection\concrete_artifact_manager.py,613.0
ansible.galaxy.collection.concrete_artifact_manager._get_meta_from_tar,701,6,5,1,5,0,0,48.0,1.0,0.0,D:\BaiduNetdiskDownload\graduation_project\project_folder\ansible\galaxy\collection\concrete_artifact_manager.py,701.0
ansible.galaxy.collection.concrete_artifact_manager._normalize_galaxy_yml_manifest,524,7,6,1,6,0,0,77.0,2.0,0.0,D:\BaiduNetdiskDownload\graduation_project\project_folder\ansible\galaxy\collection\concrete_artifact_manager.py,524.0
ansible.galaxy.collection.concrete_artifact_manager._tarfile_extract,752,3,0,3,0,0,0,11.0,2.0,0.0,D:\BaiduNetdiskDownload\graduation_project\project_folder\ansible\galaxy\collection\concrete_artifact_manager.py,752.0
ansible.galaxy.collection.concrete_artifact_manager.parse_scm,384,5,4,1,4,0,0,25.0,2.0,0.0,D:\BaiduNetdiskDownload\graduation_project\project_folder\ansible\galaxy\collection\concrete_artifact_manager.py,384.0
ansible.galaxy.collection.galaxy_api_proxy.MultiGalaxyAPIProxy.__init__,30,2,0,2,0,0,0,6.0,3.0,0.0,D:\BaiduNetdiskDownload\graduation_project\project_folder\ansible\galaxy\collection\galaxy_api_proxy.py,30.0
ansible.galaxy.collection.galaxy_api_proxy.MultiGalaxyAPIProxy._assert_that_offline_mode_is_not_requested,41,2,0,2,0,0,0,3.0,1.0,0.0,D:\BaiduNetdiskDownload\graduation_project\project_folder\ansible\galaxy\collection\galaxy_api_proxy.py,41.0
ansible.galaxy.collection.galaxy_api_proxy.MultiGalaxyAPIProxy._get_collection_versions,45,4,3,1,3,0,0,43.0,2.0,0.0,D:\BaiduNetdiskDownload\graduation_project\project_folder\ansible\galaxy\collection\galaxy_api_proxy.py,45.0
ansible.galaxy.collection.galaxy_api_proxy.MultiGalaxyAPIProxy.get_collection_dependencies,163,3,2,1,2,0,0,16.0,2.0,0.0,D:\BaiduNetdiskDownload\graduation_project\project_folder\ansible\galaxy\collection\galaxy_api_proxy.py,163.0
ansible.galaxy.collection.galaxy_api_proxy.MultiGalaxyAPIProxy.get_collection_version_metadata,113,7,5,2,5,0,0,49.0,2.0,0.0,D:\BaiduNetdiskDownload\graduation_project\project_folder\ansible\galaxy\collection\galaxy_api_proxy.py,113.0
ansible.galaxy.collection.galaxy_api_proxy.MultiGalaxyAPIProxy.get_collection_versions,89,2,2,0,2,0,0,23.0,2.0,0.0,D:\BaiduNetdiskDownload\graduation_project\project_folder\ansible\galaxy\collection\galaxy_api_proxy.py,89.0
ansible.galaxy.collection.galaxy_api_proxy.MultiGalaxyAPIProxy.get_signatures,180,6,5,1,5,0,0,36.0,2.0,0.0,D:\BaiduNetdiskDownload\graduation_project\project_folder\ansible\galaxy\collection\galaxy_api_proxy.py,180.0
ansible.galaxy.collection.gpg.GpgBaseError.__post_init__,140,1,1,0,1,0,0,3.0,1.0,0.0,D:\BaiduNetdiskDownload\graduation_project\project_folder\ansible\galaxy\collection\gpg.py,140.0
ansible.galaxy.collection.gpg.GpgBaseError.get_gpg_error_description,136,3,2,1,2,0,0,3.0,1.0,0.0,D:\BaiduNetdiskDownload\graduation_project\project_folder\ansible\galaxy\collection\gpg.py,136.0
ansible.galaxy.collection.gpg.get_signature_from_source,30,7,5,2,5,0,0,17.0,1.0,0.0,D:\BaiduNetdiskDownload\graduation_project\project_folder\ansible\galaxy\collection\gpg.py,30.0
ansible.galaxy.collection.gpg.parse_gpg_errors,104,4,3,1,3,0,0,25.0,1.0,0.0,D:\BaiduNetdiskDownload\graduation_project\project_folder\ansible\galaxy\collection\gpg.py,104.0
ansible.galaxy.collection.gpg.run_gpg_verify,49,5,4,1,4,0,0,53.0,4.0,0.0,D:\BaiduNetdiskDownload\graduation_project\project_folder\ansible\galaxy\collection\gpg.py,49.0
ansible.galaxy.dependency_resolution.__init__.build_collection_dependency_resolver,23,2,1,1,1,0,0,27.0,2.0,0.0,D:\BaiduNetdiskDownload\graduation_project\project_folder\ansible\galaxy\dependency_resolution\__init__.py,23.0
ansible.galaxy.dependency_resolution.dataclasses.Candidate.__new__,618,3,0,3,0,0,0,3.0,3.0,0.0,D:\BaiduNetdiskDownload\graduation_project\project_folder\ansible\galaxy\dependency_resolution\dataclasses.py,618.0
ansible.galaxy.dependency_resolution.dataclasses.Candidate.with_signatures_repopulated,625,2,1,1,1,0,0,9.0,1.0,0.0,D:\BaiduNetdiskDownload\graduation_project\project_folder\ansible\galaxy\dependency_resolution\dataclasses.py,625.0
ansible.galaxy.dependency_resolution.dataclasses.Requirement.__new__,604,1,0,1,0,0,0,3.0,3.0,0.0,D:\BaiduNetdiskDownload\graduation_project\project_folder\ansible\galaxy\dependency_resolution\dataclasses.py,604.0
ansible.galaxy.dependency_resolution.dataclasses._ComputedReqKindsMixin.__init__,171,3,3,0,3,0,0,12.0,3.0,0.0,D:\BaiduNetdiskDownload\graduation_project\project_folder\ansible\galaxy\dependency_resolution\dataclasses.py,171.0
ansible.galaxy.dependency_resolution.dataclasses._ComputedReqKindsMixin.__repr__,453,1,1,0,1,0,0,5.0,1.0,0.0,D:\BaiduNetdiskDownload\graduation_project\project_folder\ansible\galaxy\dependency_resolution\dataclasses.py,453.0
ansible.galaxy.dependency_resolution.dataclasses._ComputedReqKindsMixin.__str__,459,1,1,0,1,0,0,2.0,1.0,0.0,D:\BaiduNetdiskDownload\graduation_project\project_folder\ansible\galaxy\dependency_resolution\dataclasses.py,459.0
ansible.galaxy.dependency_resolution.dataclasses._ComputedReqKindsMixin.__unicode__,462,3,2,1,2,0,0,11.0,1.0,0.0,D:\BaiduNetdiskDownload\graduation_project\project_folder\ansible\galaxy\dependency_resolution\dataclasses.py,462.0
ansible.galaxy.dependency_resolution.dataclasses._ComputedReqKindsMixin._get_separate_ns_n_name,500,3,1,2,1,0,0,2.0,1.0,0.0,D:\BaiduNetdiskDownload\graduation_project\project_folder\ansible\galaxy\dependency_resolution\dataclasses.py,500.0
ansible.galaxy.dependency_resolution.dataclasses._ComputedReqKindsMixin.canonical_package_id,518,1,1,0,1,0,0,8.0,1.0,0.0,D:\BaiduNetdiskDownload\graduation_project\project_folder\ansible\galaxy\dependency_resolution\dataclasses.py,518.0
ansible.galaxy.dependency_resolution.dataclasses._ComputedReqKindsMixin.construct_galaxy_info_path,484,5,3,2,3,0,0,15.0,2.0,0.0,D:\BaiduNetdiskDownload\graduation_project\project_folder\ansible\galaxy\dependency_resolution\dataclasses.py,484.0
ansible.galaxy.dependency_resolution.dataclasses._ComputedReqKindsMixin.from_dir_path,218,12,9,3,9,0,0,25.0,3.0,0.0,D:\BaiduNetdiskDownload\graduation_project\project_folder\ansible\galaxy\dependency_resolution\dataclasses.py,191.0
ansible.galaxy.dependency_resolution.dataclasses._ComputedReqKindsMixin.from_dir_path_as_unknown,191,4,3,1,3,0,0,25.0,3.0,0.0,D:\BaiduNetdiskDownload\graduation_project\project_folder\ansible\galaxy\dependency_resolution\dataclasses.py,191.0
ansible.galaxy.dependency_resolution.dataclasses._ComputedReqKindsMixin.from_dir_path_implicit,264,7,6,1,6,0,0,17.0,2.0,0.0,D:\BaiduNetdiskDownload\graduation_project\project_folder\ansible\galaxy\dependency_resolution\dataclasses.py,264.0
ansible.galaxy.dependency_resolution.dataclasses._ComputedReqKindsMixin.from_requirement_dict,309,17,15,2,15,0,0,143.0,3.0,0.0,D:\BaiduNetdiskDownload\graduation_project\project_folder\ansible\galaxy\dependency_resolution\dataclasses.py,309.0
ansible.galaxy.dependency_resolution.dataclasses._ComputedReqKindsMixin.from_string,283,8,5,3,5,0,0,24.0,4.0,0.0,D:\BaiduNetdiskDownload\graduation_project\project_folder\ansible\galaxy\dependency_resolution\dataclasses.py,283.0
ansible.galaxy.dependency_resolution.dataclasses._ComputedReqKindsMixin.is_pinned,567,2,2,0,2,0,0,19.0,1.0,0.0,D:\BaiduNetdiskDownload\graduation_project\project_folder\ansible\galaxy\dependency_resolution\dataclasses.py,567.0
ansible.galaxy.dependency_resolution.dataclasses._ComputedReqKindsMixin.may_have_offline_galaxy_info,475,1,1,0,1,0,0,8.0,1.0,0.0,D:\BaiduNetdiskDownload\graduation_project\project_folder\ansible\galaxy\dependency_resolution\dataclasses.py,475.0
ansible.galaxy.dependency_resolution.dataclasses._ComputedReqKindsMixin.name,511,1,1,0,1,0,0,5.0,1.0,0.0,D:\BaiduNetdiskDownload\graduation_project\project_folder\ansible\galaxy\dependency_resolution\dataclasses.py,504.0
ansible.galaxy.dependency_resolution.dataclasses._ComputedReqKindsMixin.namespace,504,1,1,0,1,0,0,5.0,1.0,0.0,D:\BaiduNetdiskDownload\graduation_project\project_folder\ansible\galaxy\dependency_resolution\dataclasses.py,504.0
ansible.galaxy.dependency_resolution.dataclasses._ComputedReqKindsMixin.namespace_collection_paths,540,1,1,0,1,0,0,5.0,1.0,0.0,D:\BaiduNetdiskDownload\graduation_project\project_folder\ansible\galaxy\dependency_resolution\dataclasses.py,540.0
ansible.galaxy.dependency_resolution.dataclasses._find_collections_in_subdirs,122,3,1,2,1,0,0,14.0,1.0,0.0,D:\BaiduNetdiskDownload\graduation_project\project_folder\ansible\galaxy\dependency_resolution\dataclasses.py,122.0
ansible.galaxy.dependency_resolution.dataclasses._is_collection_dir,115,5,2,3,2,0,0,5.0,1.0,0.0,D:\BaiduNetdiskDownload\graduation_project\project_folder\ansible\galaxy\dependency_resolution\dataclasses.py,115.0
ansible.galaxy.dependency_resolution.dataclasses._is_collection_namespace_dir,138,2,1,1,1,0,0,2.0,1.0,0.0,D:\BaiduNetdiskDownload\graduation_project\project_folder\ansible\galaxy\dependency_resolution\dataclasses.py,138.0
ansible.galaxy.dependency_resolution.dataclasses._is_collection_src_dir,105,3,1,2,1,0,0,3.0,1.0,0.0,D:\BaiduNetdiskDownload\graduation_project\project_folder\ansible\galaxy\dependency_resolution\dataclasses.py,105.0
ansible.galaxy.dependency_resolution.dataclasses._is_concrete_artifact_pointer,154,2,0,2,0,0,0,12.0,1.0,0.0,D:\BaiduNetdiskDownload\graduation_project\project_folder\ansible\galaxy\dependency_resolution\dataclasses.py,154.0
ansible.galaxy.dependency_resolution.dataclasses._is_file_path,142,2,1,1,1,0,0,2.0,1.0,0.0,D:\BaiduNetdiskDownload\graduation_project\project_folder\ansible\galaxy\dependency_resolution\dataclasses.py,142.0
ansible.galaxy.dependency_resolution.dataclasses._is_git_url,150,2,1,1,1,0,0,2.0,1.0,0.0,D:\BaiduNetdiskDownload\graduation_project\project_folder\ansible\galaxy\dependency_resolution\dataclasses.py,150.0
ansible.galaxy.dependency_resolution.dataclasses._is_http_url,146,2,1,1,1,0,0,2.0,1.0,0.0,D:\BaiduNetdiskDownload\graduation_project\project_folder\ansible\galaxy\dependency_resolution\dataclasses.py,146.0
ansible.galaxy.dependency_resolution.dataclasses._is_installed_collection_dir,110,4,1,3,1,0,0,3.0,1.0,0.0,D:\BaiduNetdiskDownload\graduation_project\project_folder\ansible\galaxy\dependency_resolution\dataclasses.py,110.0
ansible.galaxy.dependency_resolution.dataclasses._validate_v1_source_info_schema,75,4,3,1,3,0,0,28.0,4.0,0.0,D:\BaiduNetdiskDownload\graduation_project\project_folder\ansible\galaxy\dependency_resolution\dataclasses.py,75.0
ansible.galaxy.dependency_resolution.dataclasses.get_validated_source_info,46,5,4,1,4,0,0,27.0,4.0,0.0,D:\BaiduNetdiskDownload\graduation_project\project_folder\ansible\galaxy\dependency_resolution\dataclasses.py,46.0
ansible.galaxy.dependency_resolution.providers.CollectionDependencyProvider050.find_matches,464,1,1,0,1,0,0,3.0,2.0,0.0,D:\BaiduNetdiskDownload\graduation_project\project_folder\ansible\galaxy\dependency_resolution\providers.py,464.0
ansible.galaxy.dependency_resolution.providers.CollectionDependencyProvider050.get_preference,468,1,1,0,1,0,0,3.0,4.0,0.0,D:\BaiduNetdiskDownload\graduation_project\project_folder\ansible\galaxy\dependency_resolution\providers.py,468.0
ansible.galaxy.dependency_resolution.providers.CollectionDependencyProvider060.find_matches,474,1,1,0,1,0,0,6.0,4.0,0.0,D:\BaiduNetdiskDownload\graduation_project\project_folder\ansible\galaxy\dependency_resolution\providers.py,474.0
ansible.galaxy.dependency_resolution.providers.CollectionDependencyProvider060.get_preference,481,1,1,0,1,0,0,3.0,4.0,0.0,D:\BaiduNetdiskDownload\graduation_project\project_folder\ansible\galaxy\dependency_resolution\providers.py,481.0
ansible.galaxy.dependency_resolution.providers.CollectionDependencyProvider070.get_preference,487,1,1,0,1,0,0,3.0,5.0,0.0,D:\BaiduNetdiskDownload\graduation_project\project_folder\ansible\galaxy\dependency_resolution\providers.py,487.0
ansible.galaxy.dependency_resolution.providers.CollectionDependencyProvider080.get_preference,493,1,1,0,1,0,0,3.0,6.0,0.0,D:\BaiduNetdiskDownload\graduation_project\project_folder\ansible\galaxy\dependency_resolution\providers.py,493.0
ansible.galaxy.dependency_resolution.providers.CollectionDependencyProviderBase._find_matches,231,11,9,2,9,0,0,169.0,2.0,0.0,D:\BaiduNetdiskDownload\graduation_project\project_folder\ansible\galaxy\dependency_resolution\providers.py,231.0
ansible.galaxy.dependency_resolution.providers.CollectionDependencyProviderBase._get_preference,184,4,0,4,0,0,0,10.0,2.0,0.0,D:\BaiduNetdiskDownload\graduation_project\project_folder\ansible\galaxy\dependency_resolution\providers.py,184.0
ansible.galaxy.dependency_resolution.providers.CollectionDependencyProviderBase.get_dependencies,428,2,2,0,2,0,0,32.0,2.0,0.0,D:\BaiduNetdiskDownload\graduation_project\project_folder\ansible\galaxy\dependency_resolution\providers.py,428.0
ansible.galaxy.dependency_resolution.providers.CollectionDependencyProviderBase.is_satisfied_by,401,2,1,1,1,0,0,26.0,3.0,0.0,D:\BaiduNetdiskDownload\graduation_project\project_folder\ansible\galaxy\dependency_resolution\providers.py,401.0
ansible.galaxy.dependency_resolution.providers._get_provider,498,2,1,1,1,0,0,8.0,1.0,0.0,D:\BaiduNetdiskDownload\graduation_project\project_folder\ansible\galaxy\dependency_resolution\providers.py,498.0
ansible.galaxy.dependency_resolution.versioning.is_pre_release,14,2,1,1,1,0,0,7.0,1.0,0.0,D:\BaiduNetdiskDownload\graduation_project\project_folder\ansible\galaxy\dependency_resolution\versioning.py,14.0
ansible.galaxy.dependency_resolution.versioning.meets_requirements,23,6,4,2,4,0,0,47.0,2.0,0.0,D:\BaiduNetdiskDownload\graduation_project\project_folder\ansible\galaxy\dependency_resolution\versioning.py,23.0
ansible.galaxy.role.GalaxyRole.__init__,83,8,2,6,2,0,0,37.0,4.0,0.0,D:\BaiduNetdiskDownload\graduation_project\project_folder\ansible\galaxy\role.py,83.0
ansible.galaxy.role.GalaxyRole._write_galaxy_install_info,205,3,2,1,2,0,0,21.0,1.0,0.0,D:\BaiduNetdiskDownload\graduation_project\project_folder\ansible\galaxy\role.py,205.0
ansible.galaxy.role.GalaxyRole.fetch,242,8,7,1,7,0,0,29.0,2.0,0.0,D:\BaiduNetdiskDownload\graduation_project\project_folder\ansible\galaxy\role.py,242.0
ansible.galaxy.role.GalaxyRole.install,272,19,19,0,19,0,0,17.0,1.0,0.0,D:\BaiduNetdiskDownload\graduation_project\project_folder\ansible\galaxy\role.py,179.0
ansible.galaxy.role.GalaxyRole.install_info,179,1,1,0,1,0,0,17.0,1.0,0.0,D:\BaiduNetdiskDownload\graduation_project\project_folder\ansible\galaxy\role.py,179.0
ansible.galaxy.role.GalaxyRole.metadata,141,1,1,0,1,0,0,18.0,1.0,0.0,D:\BaiduNetdiskDownload\graduation_project\project_folder\ansible\galaxy\role.py,141.0
ansible.galaxy.role.GalaxyRole.remove,227,3,0,3,0,0,0,14.0,1.0,0.0,D:\BaiduNetdiskDownload\graduation_project\project_folder\ansible\galaxy\role.py,227.0
ansible.galaxy.role.GalaxyRole.requirements,463,1,1,0,1,0,0,23.0,1.0,0.0,D:\BaiduNetdiskDownload\graduation_project\project_folder\ansible\galaxy\role.py,463.0
ansible.galaxy.role._check_working_data_filter,50,1,0,1,0,0,0,23.0,1.0,0.0,D:\BaiduNetdiskDownload\graduation_project\project_folder\ansible\galaxy\role.py,50.0
ansible.galaxy.token.BasicAuthToken.__init__,163,1,0,1,0,0,0,4.0,2.0,0.0,D:\BaiduNetdiskDownload\graduation_project\project_folder\ansible\galaxy\token.py,163.0
ansible.galaxy.token.BasicAuthToken._encode_token,169,3,2,1,2,0,0,5.0,2.0,0.0,D:\BaiduNetdiskDownload\graduation_project\project_folder\ansible\galaxy\token.py,169.0
ansible.galaxy.token.BasicAuthToken.get,175,2,1,1,1,0,0,7.0,1.0,0.0,D:\BaiduNetdiskDownload\graduation_project\project_folder\ansible\galaxy\token.py,175.0
ansible.galaxy.token.BasicAuthToken.headers,183,1,1,0,1,0,0,4.0,1.0,0.0,D:\BaiduNetdiskDownload\graduation_project\project_folder\ansible\galaxy\token.py,183.0
ansible.galaxy.token.GalaxyToken.__init__,105,2,1,1,1,0,0,5.0,1.0,0.0,D:\BaiduNetdiskDownload\graduation_project\project_folder\ansible\galaxy\token.py,105.0
ansible.galaxy.token.GalaxyToken._read,122,3,2,1,2,0,0,18.0,1.0,0.0,D:\BaiduNetdiskDownload\graduation_project\project_folder\ansible\galaxy\token.py,122.0
ansible.galaxy.token.GalaxyToken.config,112,1,1,0,1,0,0,9.0,1.0,0.0,D:\BaiduNetdiskDownload\graduation_project\project_folder\ansible\galaxy\token.py,112.0
ansible.galaxy.token.GalaxyToken.get,145,3,1,2,1,1,1,2.0,1.0,0.0,D:\BaiduNetdiskDownload\graduation_project\project_folder\ansible\galaxy\token.py,145.0
ansible.galaxy.token.GalaxyToken.headers,152,1,1,0,1,0,0,6.0,1.0,0.0,D:\BaiduNetdiskDownload\graduation_project\project_folder\ansible\galaxy\token.py,152.0
ansible.galaxy.token.GalaxyToken.save,148,2,1,1,1,0,0,3.0,1.0,0.0,D:\BaiduNetdiskDownload\graduation_project\project_folder\ansible\galaxy\token.py,148.0
ansible.galaxy.token.GalaxyToken.set,141,1,1,0,1,0,0,3.0,2.0,0.0,D:\BaiduNetdiskDownload\graduation_project\project_folder\ansible\galaxy\token.py,141.0
ansible.galaxy.token.KeycloakToken.__init__,52,1,0,1,0,0,0,8.0,1.0,0.0,D:\BaiduNetdiskDownload\graduation_project\project_folder\ansible\galaxy\token.py,52.0
ansible.galaxy.token.KeycloakToken._form_payload,61,1,0,1,0,0,0,3.0,1.0,0.0,D:\BaiduNetdiskDownload\graduation_project\project_folder\ansible\galaxy\token.py,61.0
ansible.galaxy.token.KeycloakToken.get,65,6,5,1,5,0,0,28.0,1.0,0.0,D:\BaiduNetdiskDownload\graduation_project\project_folder\ansible\galaxy\token.py,65.0
ansible.galaxy.token.KeycloakToken.headers,94,1,1,0,1,0,0,4.0,1.0,0.0,D:\BaiduNetdiskDownload\graduation_project\project_folder\ansible\galaxy\token.py,94.0
ansible.galaxy.user_agent.user_agent,12,7,1,6,1,0,0,11.0,1.0,0.0,D:\BaiduNetdiskDownload\graduation_project\project_folder\ansible\galaxy\user_agent.py,12.0
ansible.inventory.data.InventoryData.__init__,41,4,2,2,2,0,0,18.0,1.0,0.0,D:\BaiduNetdiskDownload\graduation_project\project_folder\ansible\inventory\data.py,41.0
ansible.inventory.data.InventoryData._create_implicit_localhost,79,4,3,1,3,0,0,23.0,2.0,0.0,D:\BaiduNetdiskDownload\graduation_project\project_folder\ansible\inventory\data.py,79.0
ansible.inventory.data.InventoryData.add_child,257,13,3,10,3,0,0,16.0,3.0,0.0,D:\BaiduNetdiskDownload\graduation_project\project_folder\ansible\inventory\data.py,257.0
ansible.inventory.data.InventoryData.add_group,159,4,3,1,3,0,0,19.0,2.0,0.0,D:\BaiduNetdiskDownload\graduation_project\project_folder\ansible\inventory\data.py,159.0
ansible.inventory.data.InventoryData.add_host,190,7,7,0,7,0,0,44.0,2.0,0.0,D:\BaiduNetdiskDownload\graduation_project\project_folder\ansible\inventory\data.py,190.0
ansible.inventory.data.InventoryData.get_groups_dict,274,1,1,0,1,0,0,9.0,1.0,0.0,D:\BaiduNetdiskDownload\graduation_project\project_folder\ansible\inventory\data.py,274.0
ansible.inventory.data.InventoryData.get_host,147,1,1,0,1,0,0,11.0,2.0,0.0,D:\BaiduNetdiskDownload\graduation_project\project_folder\ansible\inventory\data.py,147.0
ansible.inventory.data.InventoryData.reconcile_inventory,103,9,9,0,9,0,0,43.0,1.0,0.0,D:\BaiduNetdiskDownload\graduation_project\project_folder\ansible\inventory\data.py,103.0
ansible.inventory.data.InventoryData.remove_group,179,1,1,0,1,0,0,10.0,2.0,0.0,D:\BaiduNetdiskDownload\graduation_project\project_folder\ansible\inventory\data.py,179.0
ansible.inventory.data.InventoryData.remove_host,235,1,0,1,0,0,0,8.0,2.0,0.0,D:\BaiduNetdiskDownload\graduation_project\project_folder\ansible\inventory\data.py,235.0
ansible.inventory.data.InventoryData.set_variable,244,3,2,1,2,0,0,12.0,4.0,0.0,D:\BaiduNetdiskDownload\graduation_project\project_folder\ansible\inventory\data.py,244.0
ansible.inventory.group.Group.__getstate__,85,1,1,0,1,0,0,2.0,1.0,0.0,D:\BaiduNetdiskDownload\graduation_project\project_folder\ansible\inventory\group.py,85.0
ansible.inventory.group.Group.__init__,67,4,1,3,1,0,0,11.0,1.0,0.0,D:\BaiduNetdiskDownload\graduation_project\project_folder\ansible\inventory\group.py,67.0
ansible.inventory.group.Group.__repr__,79,1,1,0,1,0,0,2.0,1.0,0.0,D:\BaiduNetdiskDownload\graduation_project\project_folder\ansible\inventory\group.py,79.0
ansible.inventory.group.Group.__setstate__,88,1,1,0,1,0,0,2.0,2.0,0.0,D:\BaiduNetdiskDownload\graduation_project\project_folder\ansible\inventory\group.py,88.0
ansible.inventory.group.Group.__str__,82,1,1,0,1,0,0,2.0,1.0,0.0,D:\BaiduNetdiskDownload\graduation_project\project_folder\ansible\inventory\group.py,82.0
ansible.inventory.group.Group._check_children_depth,211,2,1,1,1,0,0,18.0,1.0,0.0,D:\BaiduNetdiskDownload\graduation_project\project_folder\ansible\inventory\group.py,211.0
ansible.inventory.group.Group._get_hosts,272,3,2,1,2,0,0,13.0,1.0,0.0,D:\BaiduNetdiskDownload\graduation_project\project_folder\ansible\inventory\group.py,272.0
ansible.inventory.group.Group._walk_relationship,122,5,3,2,3,0,0,38.0,2.0,0.0,D:\BaiduNetdiskDownload\graduation_project\project_folder\ansible\inventory\group.py,122.0
ansible.inventory.group.Group.add_child_group,176,9,7,2,7,0,0,34.0,2.0,0.0,D:\BaiduNetdiskDownload\graduation_project\project_folder\ansible\inventory\group.py,176.0
ansible.inventory.group.Group.add_host,230,3,3,0,3,0,0,9.0,2.0,0.0,D:\BaiduNetdiskDownload\graduation_project\project_folder\ansible\inventory\group.py,230.0
ansible.inventory.group.Group.clear_hosts_cache,260,4,1,3,1,0,0,5.0,1.0,0.0,D:\BaiduNetdiskDownload\graduation_project\project_folder\ansible\inventory\group.py,260.0
ansible.inventory.group.Group.deserialize,108,3,2,1,2,0,0,13.0,2.0,0.0,D:\BaiduNetdiskDownload\graduation_project\project_folder\ansible\inventory\group.py,108.0
ansible.inventory.group.Group.get_ancestors,161,6,1,5,1,0,0,2.0,1.0,0.0,D:\BaiduNetdiskDownload\graduation_project\project_folder\ansible\inventory\group.py,161.0
ansible.inventory.group.Group.get_descendants,164,2,1,1,1,0,0,2.0,2.0,0.0,D:\BaiduNetdiskDownload\graduation_project\project_folder\ansible\inventory\group.py,164.0
ansible.inventory.group.Group.get_hosts,266,1,1,0,1,0,0,5.0,1.0,0.0,D:\BaiduNetdiskDownload\graduation_project\project_folder\ansible\inventory\group.py,266.0
ansible.inventory.group.Group.get_name,173,2,0,2,0,0,0,2.0,1.0,0.0,D:\BaiduNetdiskDownload\graduation_project\project_folder\ansible\inventory\group.py,173.0
ansible.inventory.group.Group.remove_host,240,1,1,0,1,0,0,9.0,2.0,0.0,D:\BaiduNetdiskDownload\graduation_project\project_folder\ansible\inventory\group.py,240.0
ansible.inventory.group.Group.serialize,91,2,1,1,1,0,0,16.0,1.0,0.0,D:\BaiduNetdiskDownload\graduation_project\project_folder\ansible\inventory\group.py,91.0
ansible.inventory.group.Group.set_priority,289,1,0,1,0,0,0,6.0,2.0,0.0,D:\BaiduNetdiskDownload\graduation_project\project_folder\ansible\inventory\group.py,289.0
ansible.inventory.group.Group.set_variable,250,2,2,0,2,0,0,9.0,3.0,0.0,D:\BaiduNetdiskDownload\graduation_project\project_folder\ansible\inventory\group.py,250.0
ansible.inventory.group.to_safe_group_name,32,6,3,3,3,0,0,22.0,1.0,0.0,D:\BaiduNetdiskDownload\graduation_project\project_folder\ansible\inventory\group.py,32.0
ansible.inventory.helpers.get_group_vars,28,5,2,3,2,0,0,12.0,1.0,0.0,D:\BaiduNetdiskDownload\graduation_project\project_folder\ansible\inventory\helpers.py,28.0
ansible.inventory.helpers.sort_groups,24,2,0,2,0,0,0,2.0,1.0,0.0,D:\BaiduNetdiskDownload\graduation_project\project_folder\ansible\inventory\helpers.py,24.0
ansible.inventory.host.Host.__eq__,42,1,0,1,0,0,0,4.0,2.0,0.0,D:\BaiduNetdiskDownload\graduation_project\project_folder\ansible\inventory\host.py,42.0
ansible.inventory.host.Host.__getstate__,36,1,1,0,1,0,0,2.0,1.0,0.0,D:\BaiduNetdiskDownload\graduation_project\project_folder\ansible\inventory\host.py,36.0
ansible.inventory.host.Host.__init__,88,7,2,5,2,0,0,15.0,1.0,0.0,D:\BaiduNetdiskDownload\graduation_project\project_folder\ansible\inventory\host.py,88.0
ansible.inventory.host.Host.__ne__,47,1,1,0,1,0,0,2.0,2.0,0.0,D:\BaiduNetdiskDownload\graduation_project\project_folder\ansible\inventory\host.py,47.0
ansible.inventory.host.Host.__repr__,56,1,1,0,1,0,0,2.0,1.0,0.0,D:\BaiduNetdiskDownload\graduation_project\project_folder\ansible\inventory\host.py,56.0
ansible.inventory.host.Host.__setstate__,39,1,1,0,1,0,0,2.0,2.0,0.0,D:\BaiduNetdiskDownload\graduation_project\project_folder\ansible\inventory\host.py,39.0
ansible.inventory.host.Host.__str__,53,1,1,0,1,0,0,2.0,1.0,0.0,D:\BaiduNetdiskDownload\graduation_project\project_folder\ansible\inventory\host.py,53.0
ansible.inventory.host.Host.add_group,117,3,2,1,2,0,0,12.0,2.0,0.0,D:\BaiduNetdiskDownload\graduation_project\project_folder\ansible\inventory\host.py,117.0
ansible.inventory.host.Host.deserialize,73,4,3,1,3,0,0,14.0,2.0,0.0,D:\BaiduNetdiskDownload\graduation_project\project_folder\ansible\inventory\host.py,73.0
ansible.inventory.host.Host.get_groups,152,5,0,5,0,0,0,2.0,1.0,0.0,D:\BaiduNetdiskDownload\graduation_project\project_folder\ansible\inventory\host.py,152.0
ansible.inventory.host.Host.get_magic_vars,155,3,2,1,2,0,0,11.0,1.0,0.0,D:\BaiduNetdiskDownload\graduation_project\project_folder\ansible\inventory\host.py,155.0
ansible.inventory.host.Host.get_name,104,2,0,2,0,0,0,2.0,1.0,0.0,D:\BaiduNetdiskDownload\graduation_project\project_folder\ansible\inventory\host.py,104.0
ansible.inventory.host.Host.get_vars,167,2,2,0,2,0,0,2.0,1.0,0.0,D:\BaiduNetdiskDownload\graduation_project\project_folder\ansible\inventory\host.py,167.0
ansible.inventory.host.Host.populate_ancestors,107,3,2,1,2,0,0,9.0,1.0,0.0,D:\BaiduNetdiskDownload\graduation_project\project_folder\ansible\inventory\host.py,107.0
ansible.inventory.host.Host.remove_group,130,3,2,1,2,1,1,15.0,2.0,0.0,D:\BaiduNetdiskDownload\graduation_project\project_folder\ansible\inventory\host.py,130.0
ansible.inventory.host.Host.serialize,59,2,1,1,1,0,0,13.0,1.0,0.0,D:\BaiduNetdiskDownload\graduation_project\project_folder\ansible\inventory\host.py,59.0
ansible.inventory.host.Host.set_variable,146,3,1,2,1,0,0,5.0,3.0,0.0,D:\BaiduNetdiskDownload\graduation_project\project_folder\ansible\inventory\host.py,146.0
ansible.inventory.manager.InventoryManager.__init__,142,4,2,2,2,0,0,28.0,2.0,0.0,D:\BaiduNetdiskDownload\graduation_project\project_folder\ansible\inventory\manager.py,142.0
ansible.inventory.manager.InventoryManager._apply_subscript,539,1,0,1,0,0,0,17.0,3.0,0.0,D:\BaiduNetdiskDownload\graduation_project\project_folder\ansible\inventory\manager.py,539.0
ansible.inventory.manager.InventoryManager._enumerate_matches,557,9,8,1,8,0,4,38.0,2.0,0.0,D:\BaiduNetdiskDownload\graduation_project\project_folder\ansible\inventory\manager.py,557.0
ansible.inventory.manager.InventoryManager._evaluate_patterns,428,6,5,1,5,0,4,25.0,2.0,0.0,D:\BaiduNetdiskDownload\graduation_project\project_folder\ansible\inventory\manager.py,428.0
ansible.inventory.manager.InventoryManager._fetch_inventory_plugins,199,5,4,1,4,0,0,17.0,1.0,0.0,D:\BaiduNetdiskDownload\graduation_project\project_folder\ansible\inventory\manager.py,199.0
ansible.inventory.manager.InventoryManager._match_list,354,4,3,1,3,0,0,16.0,3.0,0.0,D:\BaiduNetdiskDownload\graduation_project\project_folder\ansible\inventory\manager.py,354.0
ansible.inventory.manager.InventoryManager._match_one_pattern,454,5,4,1,4,0,4,51.0,2.0,0.0,D:\BaiduNetdiskDownload\graduation_project\project_folder\ansible\inventory\manager.py,454.0
ansible.inventory.manager.InventoryManager._split_subscript,506,4,3,1,3,0,0,32.0,2.0,0.0,D:\BaiduNetdiskDownload\graduation_project\project_folder\ansible\inventory\manager.py,506.0
ansible.inventory.manager.InventoryManager.add_dynamic_group,699,8,6,2,6,0,0,53.0,3.0,0.0,D:\BaiduNetdiskDownload\graduation_project\project_folder\ansible\inventory\manager.py,699.0
ansible.inventory.manager.InventoryManager.add_dynamic_host,659,7,5,2,5,0,0,39.0,3.0,0.0,D:\BaiduNetdiskDownload\graduation_project\project_folder\ansible\inventory\manager.py,659.0
ansible.inventory.manager.InventoryManager.add_group,186,5,1,4,1,1,1,2.0,2.0,0.0,D:\BaiduNetdiskDownload\graduation_project\project_folder\ansible\inventory\manager.py,186.0
ansible.inventory.manager.InventoryManager.add_host,183,4,1,3,1,1,1,2.0,2.0,0.0,D:\BaiduNetdiskDownload\graduation_project\project_folder\ansible\inventory\manager.py,183.0
ansible.inventory.manager.InventoryManager.clear_caches,337,2,0,2,0,0,0,4.0,1.0,0.0,D:\BaiduNetdiskDownload\graduation_project\project_folder\ansible\inventory\manager.py,337.0
ansible.inventory.manager.InventoryManager.get_groups_dict,189,2,1,1,1,1,1,2.0,1.0,0.0,D:\BaiduNetdiskDownload\graduation_project\project_folder\ansible\inventory\manager.py,189.0
ansible.inventory.manager.InventoryManager.get_host,196,5,1,4,1,1,1,2.0,2.0,0.0,D:\BaiduNetdiskDownload\graduation_project\project_folder\ansible\inventory\manager.py,196.0
ansible.inventory.manager.InventoryManager.get_hosts,371,7,4,3,4,0,4,56.0,1.0,0.0,D:\BaiduNetdiskDownload\graduation_project\project_folder\ansible\inventory\manager.py,371.0
ansible.inventory.manager.InventoryManager.groups,176,24,0,24,0,0,0,2.0,1.0,0.0,D:\BaiduNetdiskDownload\graduation_project\project_folder\ansible\inventory\manager.py,176.0
ansible.inventory.manager.InventoryManager.list_groups,607,1,0,1,0,0,0,3.0,1.0,0.0,D:\BaiduNetdiskDownload\graduation_project\project_folder\ansible\inventory\manager.py,607.0
ansible.inventory.manager.InventoryManager.list_hosts,596,5,1,4,1,0,0,10.0,1.0,0.0,D:\BaiduNetdiskDownload\graduation_project\project_folder\ansible\inventory\manager.py,596.0
ansible.inventory.manager.InventoryManager.localhost,172,1,1,0,1,0,0,2.0,1.0,0.0,D:\BaiduNetdiskDownload\graduation_project\project_folder\ansible\inventory\manager.py,172.0
ansible.inventory.manager.InventoryManager.parse_source,245,13,11,2,11,1,1,27.0,1.0,0.0,D:\BaiduNetdiskDownload\graduation_project\project_folder\ansible\inventory\manager.py,217.0
ansible.inventory.manager.InventoryManager.parse_sources,217,10,8,2,8,0,0,27.0,1.0,0.0,D:\BaiduNetdiskDownload\graduation_project\project_folder\ansible\inventory\manager.py,217.0
ansible.inventory.manager.InventoryManager.reconcile_inventory,192,6,2,4,2,1,1,3.0,1.0,0.0,D:\BaiduNetdiskDownload\graduation_project\project_folder\ansible\inventory\manager.py,192.0
ansible.inventory.manager.InventoryManager.refresh_inventory,342,6,5,1,5,0,0,11.0,1.0,0.0,D:\BaiduNetdiskDownload\graduation_project\project_folder\ansible\inventory\manager.py,342.0
ansible.inventory.manager.InventoryManager.remove_restriction,652,1,0,1,0,0,0,3.0,1.0,0.0,D:\BaiduNetdiskDownload\graduation_project\project_folder\ansible\inventory\manager.py,652.0
ansible.inventory.manager.InventoryManager.restrict_to_hosts,611,2,1,1,1,0,0,11.0,2.0,0.0,D:\BaiduNetdiskDownload\graduation_project\project_folder\ansible\inventory\manager.py,611.0
ansible.inventory.manager.InventoryManager.subset,623,11,9,2,9,0,0,28.0,2.0,0.0,D:\BaiduNetdiskDownload\graduation_project\project_folder\ansible\inventory\manager.py,623.0
ansible.inventory.manager.order_patterns,65,2,1,1,1,0,0,26.0,1.0,0.0,D:\BaiduNetdiskDownload\graduation_project\project_folder\ansible\inventory\manager.py,65.0
ansible.inventory.manager.split_host_pattern,93,8,5,3,5,1,1,44.0,1.0,0.0,D:\BaiduNetdiskDownload\graduation_project\project_folder\ansible\inventory\manager.py,93.0
ansible.module_utils.api.retry_with_delays_and_condition,141,1,1,0,1,0,0,38.0,1.0,3.0,D:\BaiduNetdiskDownload\graduation_project\project_folder\ansible\module_utils\api.py,141.0
ansible.module_utils.basic.AnsibleModule.__init__,361,54,10,44,10,0,0,102.0,2.0,0.0,D:\BaiduNetdiskDownload\graduation_project\project_folder\ansible\module_utils\basic.py,361.0
ansible.module_utils.basic.AnsibleModule._apply_operation_to_mode,1002,1,0,1,0,0,0,17.0,4.0,0.0,D:\BaiduNetdiskDownload\graduation_project\project_folder\ansible\module_utils\basic.py,1002.0
ansible.module_utils.basic.AnsibleModule._check_locale,1157,3,2,1,2,0,0,23.0,1.0,0.0,D:\BaiduNetdiskDownload\graduation_project\project_folder\ansible\module_utils\basic.py,1157.0
ansible.module_utils.basic.AnsibleModule._clean_args,1718,8,7,1,7,0,0,30.0,2.0,0.0,D:\BaiduNetdiskDownload\graduation_project\project_folder\ansible\module_utils\basic.py,1718.0
ansible.module_utils.basic.AnsibleModule._get_octal_mode_from_symbolic_perms,1021,2,1,1,1,0,0,67.0,4.0,2.0,D:\BaiduNetdiskDownload\graduation_project\project_folder\ansible\module_utils\basic.py,1021.0
ansible.module_utils.basic.AnsibleModule._load_params,1207,2,1,1,1,0,0,8.0,1.0,0.0,D:\BaiduNetdiskDownload\graduation_project\project_folder\ansible\module_utils\basic.py,1207.0
ansible.module_utils.basic.AnsibleModule._log_invocation,1298,8,7,1,7,0,0,32.0,1.0,0.0,D:\BaiduNetdiskDownload\graduation_project\project_folder\ansible\module_utils\basic.py,1298.0
ansible.module_utils.basic.AnsibleModule._log_to_syslog,1216,2,1,1,1,0,5,15.0,2.0,0.0,D:\BaiduNetdiskDownload\graduation_project\project_folder\ansible\module_utils\basic.py,1216.0
ansible.module_utils.basic.AnsibleModule._return_formatted,1399,10,8,2,8,0,6,49.0,2.0,0.0,D:\BaiduNetdiskDownload\graduation_project\project_folder\ansible\module_utils\basic.py,1399.0
ansible.module_utils.basic.AnsibleModule._set_cwd,1331,1,0,1,0,0,0,19.0,1.0,0.0,D:\BaiduNetdiskDownload\graduation_project\project_folder\ansible\module_utils\basic.py,1331.0
ansible.module_utils.basic.AnsibleModule._set_internal_properties,1181,2,1,1,1,0,0,22.0,1.0,0.0,D:\BaiduNetdiskDownload\graduation_project\project_folder\ansible\module_utils\basic.py,1181.0
ansible.module_utils.basic.AnsibleModule._symbolic_mode_to_octal,957,8,5,3,5,0,0,43.0,3.0,0.0,D:\BaiduNetdiskDownload\graduation_project\project_folder\ansible\module_utils\basic.py,957.0
ansible.module_utils.basic.AnsibleModule._unsafe_writes,1700,2,1,1,1,0,0,17.0,3.0,0.0,D:\BaiduNetdiskDownload\graduation_project\project_folder\ansible\module_utils\basic.py,1700.0
ansible.module_utils.basic.AnsibleModule.add_cleanup_file,1391,4,1,3,1,0,0,3.0,2.0,0.0,D:\BaiduNetdiskDownload\graduation_project\project_folder\ansible\module_utils\basic.py,1391.0
ansible.module_utils.basic.AnsibleModule.add_path_info,1117,6,5,1,5,0,4,39.0,2.0,0.0,D:\BaiduNetdiskDownload\graduation_project\project_folder\ansible\module_utils\basic.py,1117.0
ansible.module_utils.basic.AnsibleModule.append_to_file,2025,1,1,0,1,0,0,5.0,3.0,0.0,D:\BaiduNetdiskDownload\graduation_project\project_folder\ansible\module_utils\basic.py,2025.0
ansible.module_utils.basic.AnsibleModule.atomic_move,1588,20,8,12,8,0,0,111.0,3.0,0.0,D:\BaiduNetdiskDownload\graduation_project\project_folder\ansible\module_utils\basic.py,1588.0
ansible.module_utils.basic.AnsibleModule.backup_local,1530,10,2,8,2,0,0,15.0,2.0,0.0,D:\BaiduNetdiskDownload\graduation_project\project_folder\ansible\module_utils\basic.py,1530.0
ansible.module_utils.basic.AnsibleModule.boolean,1372,5,2,3,2,0,0,9.0,2.0,0.0,D:\BaiduNetdiskDownload\graduation_project\project_folder\ansible\module_utils\basic.py,1372.0
ansible.module_utils.basic.AnsibleModule.bytes_to_human,2031,1,1,0,1,0,0,2.0,2.0,0.0,D:\BaiduNetdiskDownload\graduation_project\project_folder\ansible\module_utils\basic.py,2031.0
ansible.module_utils.basic.AnsibleModule.check_file_absent_if_check_mode,1108,5,0,5,0,0,0,2.0,2.0,0.0,D:\BaiduNetdiskDownload\graduation_project\project_folder\ansible\module_utils\basic.py,1108.0
ansible.module_utils.basic.AnsibleModule.cleanup,1546,2,0,2,0,0,0,6.0,2.0,0.0,D:\BaiduNetdiskDownload\graduation_project\project_folder\ansible\module_utils\basic.py,1546.0
ansible.module_utils.basic.AnsibleModule.debug,1232,6,1,5,1,0,0,3.0,2.0,0.0,D:\BaiduNetdiskDownload\graduation_project\project_folder\ansible\module_utils\basic.py,1232.0
ansible.module_utils.basic.AnsibleModule.deprecate,507,3,2,1,2,0,6,10.0,2.0,0.0,D:\BaiduNetdiskDownload\graduation_project\project_folder\ansible\module_utils\basic.py,507.0
ansible.module_utils.basic.AnsibleModule.digest_from_file,1479,9,4,5,4,0,0,27.0,3.0,0.0,D:\BaiduNetdiskDownload\graduation_project\project_folder\ansible\module_utils\basic.py,1479.0
ansible.module_utils.basic.AnsibleModule.do_cleanup_files,1395,3,1,2,1,0,0,3.0,1.0,0.0,D:\BaiduNetdiskDownload\graduation_project\project_folder\ansible\module_utils\basic.py,1395.0
ansible.module_utils.basic.AnsibleModule.exit_json,1449,65,2,63,2,0,0,6.0,2.0,0.0,D:\BaiduNetdiskDownload\graduation_project\project_folder\ansible\module_utils\basic.py,1449.0
ansible.module_utils.basic.AnsibleModule.fail_json,1456,228,3,225,3,0,6,14.0,3.0,0.0,D:\BaiduNetdiskDownload\graduation_project\project_folder\ansible\module_utils\basic.py,1456.0
ansible.module_utils.basic.AnsibleModule.fail_on_missing_params,1471,2,2,0,2,0,0,7.0,1.0,0.0,D:\BaiduNetdiskDownload\graduation_project\project_folder\ansible\module_utils\basic.py,1471.0
ansible.module_utils.basic.AnsibleModule.find_mount_point,637,3,2,1,2,0,0,13.0,2.0,0.0,D:\BaiduNetdiskDownload\graduation_project\project_folder\ansible\module_utils\basic.py,637.0
ansible.module_utils.basic.AnsibleModule.get_bin_path,1351,14,3,11,3,0,0,20.0,2.0,0.0,D:\BaiduNetdiskDownload\graduation_project\project_folder\ansible\module_utils\basic.py,1351.0
ansible.module_utils.basic.AnsibleModule.get_file_attributes,936,9,6,3,6,0,0,19.0,2.0,0.0,D:\BaiduNetdiskDownload\graduation_project\project_folder\ansible\module_utils\basic.py,936.0
ansible.module_utils.basic.AnsibleModule.human_to_bytes,2037,1,1,0,1,0,0,2.0,2.0,0.0,D:\BaiduNetdiskDownload\graduation_project\project_folder\ansible\module_utils\basic.py,2037.0
ansible.module_utils.basic.AnsibleModule.is_special_selinux_path,651,5,4,1,4,0,0,23.0,2.0,0.0,D:\BaiduNetdiskDownload\graduation_project\project_folder\ansible\module_utils\basic.py,651.0
ansible.module_utils.basic.AnsibleModule.jsonify,1382,4,3,1,3,0,3,5.0,2.0,0.0,D:\BaiduNetdiskDownload\graduation_project\project_folder\ansible\module_utils\basic.py,1382.0
ansible.module_utils.basic.AnsibleModule.load_file_common_arguments,518,19,4,15,4,0,0,48.0,2.0,0.0,D:\BaiduNetdiskDownload\graduation_project\project_folder\ansible\module_utils\basic.py,518.0
ansible.module_utils.basic.AnsibleModule.log,1236,14,6,8,6,0,6,61.0,2.0,0.0,D:\BaiduNetdiskDownload\graduation_project\project_folder\ansible\module_utils\basic.py,1236.0
ansible.module_utils.basic.AnsibleModule.md5,1507,4,1,3,1,0,0,14.0,2.0,0.0,D:\BaiduNetdiskDownload\graduation_project\project_folder\ansible\module_utils\basic.py,1507.0
ansible.module_utils.basic.AnsibleModule.preserved_copy,1553,6,5,1,5,0,0,34.0,3.0,0.0,D:\BaiduNetdiskDownload\graduation_project\project_folder\ansible\module_utils\basic.py,1553.0
ansible.module_utils.basic.AnsibleModule.run_command,1749,217,14,203,14,0,2,275.0,2.0,2.0,D:\BaiduNetdiskDownload\graduation_project\project_folder\ansible\module_utils\basic.py,1749.0
ansible.module_utils.basic.AnsibleModule.safe_eval,1204,1,1,0,1,0,0,2.0,2.0,0.0,D:\BaiduNetdiskDownload\graduation_project\project_folder\ansible\module_utils\basic.py,1204.0
ansible.module_utils.basic.AnsibleModule.selinux_context,610,9,4,5,4,0,4,17.0,2.0,0.0,D:\BaiduNetdiskDownload\graduation_project\project_folder\ansible\module_utils\basic.py,610.0
ansible.module_utils.basic.AnsibleModule.selinux_default_context,595,6,3,3,3,0,0,14.0,2.0,0.0,D:\BaiduNetdiskDownload\graduation_project\project_folder\ansible\module_utils\basic.py,595.0
ansible.module_utils.basic.AnsibleModule.selinux_enabled,579,8,0,8,0,0,0,5.0,1.0,0.0,D:\BaiduNetdiskDownload\graduation_project\project_folder\ansible\module_utils\basic.py,579.0
ansible.module_utils.basic.AnsibleModule.selinux_initial_context,586,4,2,2,2,0,0,7.0,1.0,0.0,D:\BaiduNetdiskDownload\graduation_project\project_folder\ansible\module_utils\basic.py,586.0
ansible.module_utils.basic.AnsibleModule.selinux_mls_enabled,573,2,0,2,0,0,0,5.0,1.0,0.0,D:\BaiduNetdiskDownload\graduation_project\project_folder\ansible\module_utils\basic.py,573.0
ansible.module_utils.basic.AnsibleModule.set_attributes_if_different,893,10,8,2,8,0,0,42.0,4.0,0.0,D:\BaiduNetdiskDownload\graduation_project\project_folder\ansible\module_utils\basic.py,893.0
ansible.module_utils.basic.AnsibleModule.set_context_if_different,681,10,6,4,6,0,0,44.0,4.0,0.0,D:\BaiduNetdiskDownload\graduation_project\project_folder\ansible\module_utils\basic.py,681.0
ansible.module_utils.basic.AnsibleModule.set_default_selinux_context,675,4,3,1,3,0,0,5.0,3.0,0.0,D:\BaiduNetdiskDownload\graduation_project\project_folder\ansible\module_utils\basic.py,675.0
ansible.module_utils.basic.AnsibleModule.set_directory_attributes_if_different,1111,1,1,0,1,0,0,2.0,3.0,0.0,D:\BaiduNetdiskDownload\graduation_project\project_folder\ansible\module_utils\basic.py,1111.0
ansible.module_utils.basic.AnsibleModule.set_file_attributes_if_different,1114,3,1,2,1,0,0,2.0,3.0,0.0,D:\BaiduNetdiskDownload\graduation_project\project_folder\ansible\module_utils\basic.py,1114.0
ansible.module_utils.basic.AnsibleModule.set_fs_attributes_if_different,1089,22,5,17,5,0,0,18.0,3.0,0.0,D:\BaiduNetdiskDownload\graduation_project\project_folder\ansible\module_utils\basic.py,1089.0
ansible.module_utils.basic.AnsibleModule.set_group_if_different,767,10,5,5,5,0,0,40.0,4.0,0.0,D:\BaiduNetdiskDownload\graduation_project\project_folder\ansible\module_utils\basic.py,767.0
ansible.module_utils.basic.AnsibleModule.set_mode_if_different,808,10,5,5,5,0,0,84.0,4.0,0.0,D:\BaiduNetdiskDownload\graduation_project\project_folder\ansible\module_utils\basic.py,808.0
ansible.module_utils.basic.AnsibleModule.set_owner_if_different,726,10,5,5,5,0,0,40.0,4.0,0.0,D:\BaiduNetdiskDownload\graduation_project\project_folder\ansible\module_utils\basic.py,726.0
ansible.module_utils.basic.AnsibleModule.sha1,1522,6,1,5,1,0,0,3.0,2.0,0.0,D:\BaiduNetdiskDownload\graduation_project\project_folder\ansible\module_utils\basic.py,1522.0
ansible.module_utils.basic.AnsibleModule.sha256,1526,3,1,2,1,0,0,3.0,2.0,0.0,D:\BaiduNetdiskDownload\graduation_project\project_folder\ansible\module_utils\basic.py,1526.0
ansible.module_utils.basic.AnsibleModule.tmpdir,465,2,2,0,2,0,0,37.0,1.0,0.0,D:\BaiduNetdiskDownload\graduation_project\project_folder\ansible\module_utils\basic.py,465.0
ansible.module_utils.basic.AnsibleModule.user_and_group,628,4,1,3,1,0,0,8.0,2.0,0.0,D:\BaiduNetdiskDownload\graduation_project\project_folder\ansible\module_utils\basic.py,628.0
ansible.module_utils.basic.AnsibleModule.warn,503,16,2,14,2,0,6,3.0,2.0,0.0,D:\BaiduNetdiskDownload\graduation_project\project_folder\ansible\module_utils\basic.py,503.0
ansible.module_utils.basic.__getattr__,2066,1,1,0,1,0,0,47.0,1.0,0.0,D:\BaiduNetdiskDownload\graduation_project\project_folder\ansible\module_utils\basic.py,2066.0
ansible.module_utils.basic._get_available_hash_algorithms,92,1,0,1,0,0,0,17.0,1.0,0.0,D:\BaiduNetdiskDownload\graduation_project\project_folder\ansible\module_utils\basic.py,92.0
ansible.module_utils.basic._load_params,298,3,2,1,2,0,0,46.0,1.0,0.0,D:\BaiduNetdiskDownload\graduation_project\project_folder\ansible\module_utils\basic.py,298.0
ansible.module_utils.basic.get_all_subclasses,225,1,1,0,1,0,0,3.0,1.0,0.0,D:\BaiduNetdiskDownload\graduation_project\project_folder\ansible\module_utils\basic.py,225.0
ansible.module_utils.basic.heuristic_log_sanitize,233,7,4,3,4,0,0,63.0,1.0,0.0,D:\BaiduNetdiskDownload\graduation_project\project_folder\ansible\module_utils\basic.py,233.0
ansible.module_utils.basic.load_platform_subclass,219,1,1,0,1,0,0,4.0,3.0,0.0,D:\BaiduNetdiskDownload\graduation_project\project_folder\ansible\module_utils\basic.py,219.0
ansible.module_utils.basic.missing_required_lib,346,9,0,9,0,0,0,12.0,1.0,0.0,D:\BaiduNetdiskDownload\graduation_project\project_folder\ansible\module_utils\basic.py,346.0
ansible.module_utils.common._utils.get_all_subclasses,12,5,2,3,2,0,0,27.0,1.0,0.0,D:\BaiduNetdiskDownload\graduation_project\project_folder\ansible\module_utils\common\_utils.py,12.0
ansible.module_utils.common.arg_spec.ArgumentSpecValidator.__init__,97,5,2,3,2,0,0,47.0,2.0,0.0,D:\BaiduNetdiskDownload\graduation_project\project_folder\ansible\module_utils\common\arg_spec.py,97.0
ansible.module_utils.common.arg_spec.ArgumentSpecValidator.validate,145,20,17,3,17,0,0,142.0,4.0,0.0,D:\BaiduNetdiskDownload\graduation_project\project_folder\ansible\module_utils\common\arg_spec.py,145.0
ansible.module_utils.common.arg_spec.ModuleArgumentSpecValidator.__init__,296,1,0,1,0,0,0,2.0,3.0,0.0,D:\BaiduNetdiskDownload\graduation_project\project_folder\ansible\module_utils\common\arg_spec.py,296.0
ansible.module_utils.common.arg_spec.ModuleArgumentSpecValidator.validate,299,3,3,0,3,0,0,12.0,2.0,0.0,D:\BaiduNetdiskDownload\graduation_project\project_folder\ansible\module_utils\common\arg_spec.py,299.0
ansible.module_utils.common.arg_spec.ValidationResult.__init__,51,2,1,1,1,0,0,22.0,2.0,0.0,D:\BaiduNetdiskDownload\graduation_project\project_folder\ansible\module_utils\common\arg_spec.py,51.0
ansible.module_utils.common.collections.ImmutableDict.__eq__,30,1,1,0,1,0,0,8.0,2.0,0.0,D:\BaiduNetdiskDownload\graduation_project\project_folder\ansible\module_utils\common\collections.py,30.0
ansible.module_utils.common.collections.ImmutableDict.__hash__,27,2,1,1,1,0,0,2.0,1.0,0.0,D:\BaiduNetdiskDownload\graduation_project\project_folder\ansible\module_utils\common\collections.py,27.0
ansible.module_utils.common.collections.ImmutableDict.__init__,15,3,0,3,0,0,0,2.0,3.0,0.0,D:\BaiduNetdiskDownload\graduation_project\project_folder\ansible\module_utils\common\collections.py,15.0
ansible.module_utils.common.collections.ImmutableDict.__iter__,21,2,1,1,1,1,1,2.0,1.0,0.0,D:\BaiduNetdiskDownload\graduation_project\project_folder\ansible\module_utils\common\collections.py,21.0
ansible.module_utils.common.collections.ImmutableDict.__len__,24,2,1,1,1,1,1,2.0,1.0,0.0,D:\BaiduNetdiskDownload\graduation_project\project_folder\ansible\module_utils\common\collections.py,24.0
ansible.module_utils.common.collections.ImmutableDict.__repr__,39,1,1,0,1,0,0,2.0,1.0,0.0,D:\BaiduNetdiskDownload\graduation_project\project_folder\ansible\module_utils\common\collections.py,39.0
ansible.module_utils.common.collections.ImmutableDict.difference,54,1,1,0,1,0,0,11.0,2.0,0.0,D:\BaiduNetdiskDownload\graduation_project\project_folder\ansible\module_utils\common\collections.py,54.0
ansible.module_utils.common.collections.ImmutableDict.union,42,1,1,0,1,0,0,11.0,2.0,0.0,D:\BaiduNetdiskDownload\graduation_project\project_folder\ansible\module_utils\common\collections.py,42.0
ansible.module_utils.common.collections.count,99,1,1,0,1,0,0,13.0,1.0,0.0,D:\BaiduNetdiskDownload\graduation_project\project_folder\ansible\module_utils\common\collections.py,99.0
ansible.module_utils.common.collections.is_iterable,73,7,1,6,1,0,0,10.0,1.0,0.0,D:\BaiduNetdiskDownload\graduation_project\project_folder\ansible\module_utils\common\collections.py,73.0
ansible.module_utils.common.collections.is_sequence,85,19,1,18,1,0,0,12.0,1.0,0.0,D:\BaiduNetdiskDownload\graduation_project\project_folder\ansible\module_utils\common\collections.py,85.0
ansible.module_utils.common.collections.is_string,67,3,0,3,0,0,0,4.0,1.0,0.0,D:\BaiduNetdiskDownload\graduation_project\project_folder\ansible\module_utils\common\collections.py,67.0
ansible.module_utils.common.dict_transformations._camel_to_snake,85,3,2,1,2,0,0,24.0,1.0,2.0,D:\BaiduNetdiskDownload\graduation_project\project_folder\ansible\module_utils\common\dict_transformations.py,85.0
ansible.module_utils.common.dict_transformations._snake_to_camel,78,4,3,1,3,0,0,5.0,1.0,0.0,D:\BaiduNetdiskDownload\graduation_project\project_folder\ansible\module_utils\common\dict_transformations.py,78.0
ansible.module_utils.common.dict_transformations.camel_dict_to_snake_dict,15,5,4,1,4,1,1,37.0,1.0,2.0,D:\BaiduNetdiskDownload\graduation_project\project_folder\ansible\module_utils\common\dict_transformations.py,15.0
ansible.module_utils.common.dict_transformations.dict_merge,111,3,2,1,2,1,1,13.0,2.0,0.0,D:\BaiduNetdiskDownload\graduation_project\project_folder\ansible\module_utils\common\dict_transformations.py,111.0
ansible.module_utils.common.dict_transformations.recursive_diff,126,3,2,1,2,1,1,28.0,2.0,0.0,D:\BaiduNetdiskDownload\graduation_project\project_folder\ansible\module_utils\common\dict_transformations.py,126.0
ansible.module_utils.common.dict_transformations.snake_dict_to_camel_dict,54,2,2,0,2,0,0,22.0,1.0,2.0,D:\BaiduNetdiskDownload\graduation_project\project_folder\ansible\module_utils\common\dict_transformations.py,54.0
ansible.module_utils.common.file.format_attributes,82,1,0,1,0,0,0,3.0,1.0,0.0,D:\BaiduNetdiskDownload\graduation_project\project_folder\ansible\module_utils\common\file.py,82.0
ansible.module_utils.common.file.get_flags_from_attributes,87,2,2,0,2,0,0,3.0,1.0,0.0,D:\BaiduNetdiskDownload\graduation_project\project_folder\ansible\module_utils\common\file.py,87.0
ansible.module_utils.common.file.is_executable,58,4,0,4,0,0,0,22.0,1.0,0.0,D:\BaiduNetdiskDownload\graduation_project\project_folder\ansible\module_utils\common\file.py,58.0
ansible.module_utils.common.json.AnsibleJSONEncoder.default,55,1,1,0,1,0,0,20.0,2.0,0.0,D:\BaiduNetdiskDownload\graduation_project\project_folder\ansible\module_utils\common\json.py,55.0
ansible.module_utils.common.json.AnsibleJSONEncoder.iterencode,76,3,2,1,2,1,1,9.0,3.0,0.0,D:\BaiduNetdiskDownload\graduation_project\project_folder\ansible\module_utils\common\json.py,76.0
ansible.module_utils.common.json._is_unsafe,16,1,0,1,0,0,0,2.0,1.0,0.0,D:\BaiduNetdiskDownload\graduation_project\project_folder\ansible\module_utils\common\json.py,16.0
ansible.module_utils.common.json._preprocess_unsafe_encode,24,7,5,2,5,1,1,14.0,1.0,0.0,D:\BaiduNetdiskDownload\graduation_project\project_folder\ansible\module_utils\common\json.py,24.0
ansible.module_utils.common.json.json_dump,40,4,0,4,0,0,0,2.0,1.0,0.0,D:\BaiduNetdiskDownload\graduation_project\project_folder\ansible\module_utils\common\json.py,40.0
ansible.module_utils.common.locale.get_best_parsable_locale,9,22,3,19,3,0,0,52.0,1.0,0.0,D:\BaiduNetdiskDownload\graduation_project\project_folder\ansible\module_utils\common\locale.py,9.0
ansible.module_utils.common.network.is_mac,151,2,2,0,2,0,0,10.0,1.0,0.0,D:\BaiduNetdiskDownload\graduation_project\project_folder\ansible\module_utils\common\network.py,151.0
ansible.module_utils.common.network.is_masklen,31,2,0,2,0,0,0,5.0,1.0,0.0,D:\BaiduNetdiskDownload\graduation_project\project_folder\ansible\module_utils\common\network.py,31.0
ansible.module_utils.common.network.is_netmask,18,2,1,1,1,0,0,11.0,1.0,0.0,D:\BaiduNetdiskDownload\graduation_project\project_folder\ansible\module_utils\common\network.py,18.0
ansible.module_utils.common.network.to_bits,143,2,2,0,2,0,0,6.0,1.0,0.0,D:\BaiduNetdiskDownload\graduation_project\project_folder\ansible\module_utils\common\network.py,143.0
ansible.module_utils.common.network.to_ipv6_network,115,3,3,0,3,0,0,26.0,1.0,0.0,D:\BaiduNetdiskDownload\graduation_project\project_folder\ansible\module_utils\common\network.py,115.0
ansible.module_utils.common.network.to_ipv6_subnet,85,3,3,0,3,0,0,28.0,1.0,0.0,D:\BaiduNetdiskDownload\graduation_project\project_folder\ansible\module_utils\common\network.py,85.0
ansible.module_utils.common.network.to_masklen,50,4,3,1,3,0,0,11.0,1.0,0.0,D:\BaiduNetdiskDownload\graduation_project\project_folder\ansible\module_utils\common\network.py,50.0
ansible.module_utils.common.network.to_netmask,38,2,1,1,1,0,0,10.0,1.0,0.0,D:\BaiduNetdiskDownload\graduation_project\project_folder\ansible\module_utils\common\network.py,38.0
ansible.module_utils.common.network.to_subnet,63,6,6,0,6,0,0,20.0,2.0,0.0,D:\BaiduNetdiskDownload\graduation_project\project_folder\ansible\module_utils\common\network.py,63.0
ansible.module_utils.common.parameters._get_legal_inputs,151,4,1,3,1,0,0,5.0,2.0,0.0,D:\BaiduNetdiskDownload\graduation_project\project_folder\ansible\module_utils\common\parameters.py,151.0
ansible.module_utils.common.parameters._get_type_validator,124,2,0,2,0,0,0,25.0,1.0,0.0,D:\BaiduNetdiskDownload\graduation_project\project_folder\ansible\module_utils\common\parameters.py,124.0
ansible.module_utils.common.parameters._get_unsupported_parameters,158,6,4,2,4,0,0,39.0,2.0,0.0,D:\BaiduNetdiskDownload\graduation_project\project_folder\ansible\module_utils\common\parameters.py,158.0
ansible.module_utils.common.parameters._handle_aliases,199,7,3,4,3,0,0,55.0,2.0,0.0,D:\BaiduNetdiskDownload\graduation_project\project_folder\ansible\module_utils\common\parameters.py,199.0
ansible.module_utils.common.parameters._list_deprecations,256,6,4,2,4,1,1,52.0,2.0,0.0,D:\BaiduNetdiskDownload\graduation_project\project_folder\ansible\module_utils\common\parameters.py,256.0
ansible.module_utils.common.parameters._list_no_log_values,310,8,5,3,5,1,1,46.0,2.0,0.0,D:\BaiduNetdiskDownload\graduation_project\project_folder\ansible\module_utils\common\parameters.py,310.0
ansible.module_utils.common.parameters._remove_values_conditions,381,6,4,2,4,0,0,92.0,3.0,0.0,D:\BaiduNetdiskDownload\graduation_project\project_folder\ansible\module_utils\common\parameters.py,381.0
ansible.module_utils.common.parameters._return_datastructure_name,358,5,3,2,3,1,1,21.0,1.0,0.0,D:\BaiduNetdiskDownload\graduation_project\project_folder\ansible\module_utils\common\parameters.py,358.0
ansible.module_utils.common.parameters._sanitize_keys_conditions,512,2,1,1,1,0,0,36.0,4.0,0.0,D:\BaiduNetdiskDownload\graduation_project\project_folder\ansible\module_utils\common\parameters.py,512.0
ansible.module_utils.common.parameters._set_defaults,475,4,2,2,2,0,0,35.0,2.0,0.0,D:\BaiduNetdiskDownload\graduation_project\project_folder\ansible\module_utils\common\parameters.py,475.0
ansible.module_utils.common.parameters._validate_argument_types,578,8,6,2,6,0,0,68.0,2.0,0.0,D:\BaiduNetdiskDownload\graduation_project\project_folder\ansible\module_utils\common\parameters.py,578.0
ansible.module_utils.common.parameters._validate_argument_values,648,7,5,2,5,0,0,48.0,2.0,0.0,D:\BaiduNetdiskDownload\graduation_project\project_folder\ansible\module_utils\common\parameters.py,648.0
ansible.module_utils.common.parameters._validate_elements,550,5,4,1,4,0,0,26.0,3.0,0.0,D:\BaiduNetdiskDownload\graduation_project\project_folder\ansible\module_utils\common\parameters.py,550.0
ansible.module_utils.common.parameters._validate_sub_spec,698,18,16,2,16,1,1,130.0,2.0,0.0,D:\BaiduNetdiskDownload\graduation_project\project_folder\ansible\module_utils\common\parameters.py,698.0
ansible.module_utils.common.parameters.remove_values,908,7,4,3,4,0,6,32.0,2.0,0.0,D:\BaiduNetdiskDownload\graduation_project\project_folder\ansible\module_utils\common\parameters.py,908.0
ansible.module_utils.common.parameters.sanitize_keys,864,7,6,1,6,0,0,42.0,2.0,0.0,D:\BaiduNetdiskDownload\graduation_project\project_folder\ansible\module_utils\common\parameters.py,864.0
ansible.module_utils.common.parameters.set_fallbacks,839,4,2,2,2,0,0,23.0,2.0,0.0,D:\BaiduNetdiskDownload\graduation_project\project_folder\ansible\module_utils\common\parameters.py,839.0
ansible.module_utils.common.process.get_bin_path,12,16,4,12,4,0,0,42.0,1.0,0.0,D:\BaiduNetdiskDownload\graduation_project\project_folder\ansible\module_utils\common\process.py,12.0
ansible.module_utils.common.respawn._create_payload,70,3,2,1,2,0,0,27.0,1.0,0.0,D:\BaiduNetdiskDownload\graduation_project\project_folder\ansible\module_utils\common\respawn.py,70.0
ansible.module_utils.common.respawn.has_respawned,13,7,0,7,0,0,0,2.0,1.0,0.0,D:\BaiduNetdiskDownload\graduation_project\project_folder\ansible\module_utils\common\respawn.py,13.0
ansible.module_utils.common.respawn.probe_interpreters_for_module,46,7,1,6,1,0,0,22.0,2.0,0.0,D:\BaiduNetdiskDownload\graduation_project\project_folder\ansible\module_utils\common\respawn.py,46.0
ansible.module_utils.common.respawn.respawn_module,17,9,3,6,3,0,0,27.0,1.0,0.0,D:\BaiduNetdiskDownload\graduation_project\project_folder\ansible\module_utils\common\respawn.py,17.0
ansible.module_utils.common.sys_info.get_distribution,16,6,1,5,1,0,0,22.0,1.0,0.0,D:\BaiduNetdiskDownload\graduation_project\project_folder\ansible\module_utils\common\sys_info.py,16.0
ansible.module_utils.common.sys_info.get_distribution_codename,81,1,0,1,0,0,0,28.0,1.0,0.0,D:\BaiduNetdiskDownload\graduation_project\project_folder\ansible\module_utils\common\sys_info.py,81.0
ansible.module_utils.common.sys_info.get_distribution_version,40,3,2,1,2,0,0,39.0,1.0,0.0,D:\BaiduNetdiskDownload\graduation_project\project_folder\ansible\module_utils\common\sys_info.py,40.0
ansible.module_utils.common.sys_info.get_platform_subclass,111,8,2,6,2,0,0,46.0,1.0,0.0,D:\BaiduNetdiskDownload\graduation_project\project_folder\ansible\module_utils\common\sys_info.py,111.0
ansible.module_utils.common.text.converters.container_to_bytes,280,4,3,1,3,1,1,17.0,1.0,0.0,D:\BaiduNetdiskDownload\graduation_project\project_folder\ansible\module_utils\common\text\converters.py,280.0
ansible.module_utils.common.text.converters.container_to_text,299,5,3,2,3,1,1,18.0,1.0,0.0,D:\BaiduNetdiskDownload\graduation_project\project_folder\ansible\module_utils\common\text\converters.py,299.0
ansible.module_utils.common.text.converters.jsonify,269,3,1,2,1,0,0,9.0,2.0,0.0,D:\BaiduNetdiskDownload\graduation_project\project_folder\ansible\module_utils\common\text\converters.py,269.0
ansible.module_utils.common.text.converters.to_bytes,32,247,2,245,2,1,1,115.0,1.0,0.0,D:\BaiduNetdiskDownload\graduation_project\project_folder\ansible\module_utils\common\text\converters.py,32.0
ansible.module_utils.common.text.converters.to_text,149,336,2,334,2,1,1,89.0,1.0,0.0,D:\BaiduNetdiskDownload\graduation_project\project_folder\ansible\module_utils\common\text\converters.py,149.0
ansible.module_utils.common.text.formatters.bytes_to_human,98,5,2,3,2,0,0,16.0,1.0,0.0,D:\BaiduNetdiskDownload\graduation_project\project_folder\ansible\module_utils\common\text\formatters.py,98.0
ansible.module_utils.common.text.formatters.human_to_bytes,38,6,3,3,3,0,0,58.0,1.0,0.0,D:\BaiduNetdiskDownload\graduation_project\project_folder\ansible\module_utils\common\text\formatters.py,38.0
ansible.module_utils.common.text.formatters.lenient_lowercase,24,2,2,0,2,0,0,12.0,1.0,0.0,D:\BaiduNetdiskDownload\graduation_project\project_folder\ansible\module_utils\common\text\formatters.py,24.0
ansible.module_utils.common.validation.check_missing_parameters,337,3,2,1,2,0,0,24.0,1.0,0.0,D:\BaiduNetdiskDownload\graduation_project\project_folder\ansible\module_utils\common\validation.py,337.0
ansible.module_utils.common.validation.check_mutually_exclusive,69,6,4,2,4,0,0,31.0,2.0,0.0,D:\BaiduNetdiskDownload\graduation_project\project_folder\ansible\module_utils\common\validation.py,69.0
ansible.module_utils.common.validation.check_required_arguments,212,6,4,2,4,0,0,31.0,2.0,0.0,D:\BaiduNetdiskDownload\graduation_project\project_folder\ansible\module_utils\common\validation.py,212.0
ansible.module_utils.common.validation.check_required_by,172,4,4,0,4,0,0,38.0,2.0,0.0,D:\BaiduNetdiskDownload\graduation_project\project_folder\ansible\module_utils\common\validation.py,172.0
ansible.module_utils.common.validation.check_required_if,245,4,4,0,4,0,0,90.0,2.0,0.0,D:\BaiduNetdiskDownload\graduation_project\project_folder\ansible\module_utils\common\validation.py,245.0
ansible.module_utils.common.validation.check_required_one_of,102,4,4,0,4,0,0,32.0,2.0,0.0,D:\BaiduNetdiskDownload\graduation_project\project_folder\ansible\module_utils\common\validation.py,102.0
ansible.module_utils.common.validation.check_required_together,136,4,4,0,4,0,0,34.0,2.0,0.0,D:\BaiduNetdiskDownload\graduation_project\project_folder\ansible\module_utils\common\validation.py,136.0
ansible.module_utils.common.validation.check_type_bits,553,1,1,0,1,0,0,11.0,1.0,0.0,D:\BaiduNetdiskDownload\graduation_project\project_folder\ansible\module_utils\common\validation.py,553.0
ansible.module_utils.common.validation.check_type_bool,467,1,1,0,1,0,0,17.0,1.0,0.0,D:\BaiduNetdiskDownload\graduation_project\project_folder\ansible\module_utils\common\validation.py,467.0
ansible.module_utils.common.validation.check_type_bytes,542,1,1,0,1,0,0,9.0,1.0,0.0,D:\BaiduNetdiskDownload\graduation_project\project_folder\ansible\module_utils\common\validation.py,542.0
ansible.module_utils.common.validation.check_type_dict,413,7,6,1,6,0,0,52.0,1.0,0.0,D:\BaiduNetdiskDownload\graduation_project\project_folder\ansible\module_utils\common\validation.py,413.0
ansible.module_utils.common.validation.check_type_int,486,1,0,1,0,0,0,20.0,1.0,0.0,D:\BaiduNetdiskDownload\graduation_project\project_folder\ansible\module_utils\common\validation.py,486.0
ansible.module_utils.common.validation.check_type_jsonarg,566,2,2,0,2,0,0,12.0,1.0,0.0,D:\BaiduNetdiskDownload\graduation_project\project_folder\ansible\module_utils\common\validation.py,566.0
ansible.module_utils.common.validation.check_type_list,390,2,1,1,1,0,0,21.0,1.0,0.0,D:\BaiduNetdiskDownload\graduation_project\project_folder\ansible\module_utils\common\validation.py,390.0
ansible.module_utils.common.validation.check_type_path,529,1,1,0,1,0,0,6.0,1.0,0.0,D:\BaiduNetdiskDownload\graduation_project\project_folder\ansible\module_utils\common\validation.py,529.0
ansible.module_utils.common.validation.check_type_str,366,5,1,4,1,0,0,22.0,1.0,0.0,D:\BaiduNetdiskDownload\graduation_project\project_folder\ansible\module_utils\common\validation.py,366.0
ansible.module_utils.common.validation.count_terms,25,5,1,4,1,0,0,14.0,2.0,0.0,D:\BaiduNetdiskDownload\graduation_project\project_folder\ansible\module_utils\common\validation.py,25.0
ansible.module_utils.common.validation.safe_eval,41,2,0,2,0,0,0,26.0,1.0,0.0,D:\BaiduNetdiskDownload\graduation_project\project_folder\ansible\module_utils\common\validation.py,41.0
ansible.module_utils.common.warnings.deprecate,20,10,1,9,1,0,0,10.0,1.0,0.0,D:\BaiduNetdiskDownload\graduation_project\project_folder\ansible\module_utils\common\warnings.py,20.0
ansible.module_utils.common.warnings.get_deprecation_messages,37,1,0,1,0,0,0,3.0,1.0,0.0,D:\BaiduNetdiskDownload\graduation_project\project_folder\ansible\module_utils\common\warnings.py,37.0
ansible.module_utils.common.warnings.get_warning_messages,32,1,0,1,0,0,0,3.0,1.0,0.0,D:\BaiduNetdiskDownload\graduation_project\project_folder\ansible\module_utils\common\warnings.py,32.0
ansible.module_utils.common.warnings.warn,13,7,1,6,1,0,0,5.0,1.0,0.0,D:\BaiduNetdiskDownload\graduation_project\project_folder\ansible\module_utils\common\warnings.py,13.0
ansible.module_utils.compat.datetime.utcfromtimestamp,31,3,0,3,0,0,0,3.0,1.0,0.0,D:\BaiduNetdiskDownload\graduation_project\project_folder\ansible\module_utils\compat\datetime.py,31.0
ansible.module_utils.compat.datetime.utcnow,36,4,0,4,0,0,0,3.0,1.0,0.0,D:\BaiduNetdiskDownload\graduation_project\project_folder\ansible\module_utils\compat\datetime.py,36.0
ansible.module_utils.compat.importlib.__getattr__,9,1,1,0,1,0,0,18.0,1.0,0.0,D:\BaiduNetdiskDownload\graduation_project\project_folder\ansible\module_utils\compat\importlib.py,9.0
ansible.module_utils.compat.selinux._module_setup,18,4,3,1,3,0,0,54.0,1.0,2.0,D:\BaiduNetdiskDownload\graduation_project\project_folder\ansible\module_utils\compat\selinux.py,18.0
ansible.module_utils.compat.version.LooseVersion.__init__,305,20,1,19,1,0,0,3.0,1.0,0.0,D:\BaiduNetdiskDownload\graduation_project\project_folder\ansible\module_utils\compat\version.py,305.0
ansible.module_utils.compat.version.LooseVersion._cmp,329,1,1,0,1,0,0,12.0,2.0,0.0,D:\BaiduNetdiskDownload\graduation_project\project_folder\ansible\module_utils\compat\version.py,329.0
ansible.module_utils.compat.version.LooseVersion.parse,309,2,1,1,1,0,0,13.0,2.0,0.0,D:\BaiduNetdiskDownload\graduation_project\project_folder\ansible\module_utils\compat\version.py,309.0
ansible.module_utils.compat.version.StrictVersion.__str__,157,1,1,0,1,0,0,10.0,1.0,0.0,D:\BaiduNetdiskDownload\graduation_project\project_folder\ansible\module_utils\compat\version.py,157.0
ansible.module_utils.compat.version.StrictVersion.parse,139,1,1,0,1,0,0,17.0,2.0,0.0,D:\BaiduNetdiskDownload\graduation_project\project_folder\ansible\module_utils\compat\version.py,139.0
ansible.module_utils.compat.version.Version.__init__,45,2,0,2,0,0,0,3.0,1.0,0.0,D:\BaiduNetdiskDownload\graduation_project\project_folder\ansible\module_utils\compat\version.py,45.0
ansible.module_utils.connection.Connection.__getattr__,110,1,1,0,1,0,0,7.0,2.0,0.0,D:\BaiduNetdiskDownload\graduation_project\project_folder\ansible\module_utils\connection.py,110.0
ansible.module_utils.connection.Connection.__init__,105,4,0,4,0,0,0,4.0,2.0,0.0,D:\BaiduNetdiskDownload\graduation_project\project_folder\ansible\module_utils\connection.py,105.0
ansible.module_utils.connection.Connection.__rpc__,167,3,3,0,3,0,0,19.0,4.0,0.0,D:\BaiduNetdiskDownload\graduation_project\project_folder\ansible\module_utils\connection.py,167.0
ansible.module_utils.connection.Connection._exec_jsonrpc,118,10,9,1,9,0,0,48.0,4.0,0.0,D:\BaiduNetdiskDownload\graduation_project\project_folder\ansible\module_utils\connection.py,118.0
ansible.module_utils.connection.Connection.send,187,8,5,3,5,0,0,19.0,2.0,0.0,D:\BaiduNetdiskDownload\graduation_project\project_folder\ansible\module_utils\connection.py,187.0
ansible.module_utils.connection.ConnectionError.__init__,97,6,1,5,1,0,0,4.0,4.0,0.0,D:\BaiduNetdiskDownload\graduation_project\project_folder\ansible\module_utils\connection.py,97.0
ansible.module_utils.connection.exec_command,76,3,3,0,3,0,0,9.0,2.0,0.0,D:\BaiduNetdiskDownload\graduation_project\project_folder\ansible\module_utils\connection.py,76.0
ansible.module_utils.connection.recv_data,58,3,1,2,1,0,0,16.0,1.0,0.0,D:\BaiduNetdiskDownload\graduation_project\project_folder\ansible\module_utils\connection.py,58.0
ansible.module_utils.connection.request_builder,87,1,0,1,0,0,0,6.0,3.0,0.0,D:\BaiduNetdiskDownload\graduation_project\project_folder\ansible\module_utils\connection.py,87.0
ansible.module_utils.connection.send_data,53,2,0,2,0,0,0,3.0,2.0,0.0,D:\BaiduNetdiskDownload\graduation_project\project_folder\ansible\module_utils\connection.py,53.0
ansible.module_utils.connection.write_to_stream,45,2,1,1,1,0,0,6.0,2.0,0.0,D:\BaiduNetdiskDownload\graduation_project\project_folder\ansible\module_utils\connection.py,45.0
ansible.module_utils.distro._distro.LinuxDistribution.__init__,667,2,0,2,0,0,0,132.0,1.0,0.0,D:\BaiduNetdiskDownload\graduation_project\project_folder\ansible\module_utils\distro\_distro.py,667.0
ansible.module_utils.distro._distro.LinuxDistribution.__repr__,800,1,1,0,1,0,0,16.0,1.0,0.0,D:\BaiduNetdiskDownload\graduation_project\project_folder\ansible\module_utils\distro\_distro.py,800.0
ansible.module_utils.distro._distro.LinuxDistribution._debian_version,1219,1,1,0,1,0,0,8.0,1.0,0.0,D:\BaiduNetdiskDownload\graduation_project\project_folder\ansible\module_utils\distro\_distro.py,1219.0
ansible.module_utils.distro._distro.LinuxDistribution._distro_release_info,1253,3,3,0,3,0,0,57.0,1.0,0.0,D:\BaiduNetdiskDownload\graduation_project\project_folder\ansible\module_utils\distro\_distro.py,1253.0
ansible.module_utils.distro._distro.LinuxDistribution._lsb_release_info,1154,3,3,0,3,0,0,17.0,1.0,0.0,D:\BaiduNetdiskDownload\graduation_project\project_folder\ansible\module_utils\distro\_distro.py,1154.0
ansible.module_utils.distro._distro.LinuxDistribution._os_release_info,1091,1,1,0,1,0,0,11.0,1.0,0.0,D:\BaiduNetdiskDownload\graduation_project\project_folder\ansible\module_utils\distro\_distro.py,1091.0
ansible.module_utils.distro._distro.LinuxDistribution._oslevel_info,1209,2,2,0,2,0,0,8.0,1.0,0.0,D:\BaiduNetdiskDownload\graduation_project\project_folder\ansible\module_utils\distro\_distro.py,1209.0
ansible.module_utils.distro._distro.LinuxDistribution._parse_distro_release_content,1334,4,2,2,2,0,0,23.0,1.0,0.0,D:\BaiduNetdiskDownload\graduation_project\project_folder\ansible\module_utils\distro\_distro.py,1334.0
ansible.module_utils.distro._distro.LinuxDistribution._parse_distro_release_file,1311,2,1,1,1,0,0,21.0,2.0,0.0,D:\BaiduNetdiskDownload\graduation_project\project_folder\ansible\module_utils\distro\_distro.py,1311.0
ansible.module_utils.distro._distro.LinuxDistribution._parse_lsb_release_content,1173,5,4,1,4,0,0,22.0,1.0,0.0,D:\BaiduNetdiskDownload\graduation_project\project_folder\ansible\module_utils\distro\_distro.py,1173.0
ansible.module_utils.distro._distro.LinuxDistribution._parse_os_release_content,1104,3,2,1,2,0,0,48.0,1.0,0.0,D:\BaiduNetdiskDownload\graduation_project\project_folder\ansible\module_utils\distro\_distro.py,1104.0
ansible.module_utils.distro._distro.LinuxDistribution._parse_uname_content,1229,4,3,1,3,0,0,17.0,1.0,0.0,D:\BaiduNetdiskDownload\graduation_project\project_folder\ansible\module_utils\distro\_distro.py,1229.0
ansible.module_utils.distro._distro.LinuxDistribution._to_str,1248,4,1,3,1,0,0,3.0,1.0,0.0,D:\BaiduNetdiskDownload\graduation_project\project_folder\ansible\module_utils\distro\_distro.py,1248.0
ansible.module_utils.distro._distro.LinuxDistribution._uname_info,1197,3,3,0,3,0,0,10.0,1.0,0.0,D:\BaiduNetdiskDownload\graduation_project\project_folder\ansible\module_utils\distro\_distro.py,1197.0
ansible.module_utils.distro._distro.LinuxDistribution.build_number,958,3,1,2,1,0,0,7.0,1.0,0.0,D:\BaiduNetdiskDownload\graduation_project\project_folder\ansible\module_utils\distro\_distro.py,958.0
ansible.module_utils.distro._distro.LinuxDistribution.codename,974,7,2,5,2,0,0,16.0,1.0,0.0,D:\BaiduNetdiskDownload\graduation_project\project_folder\ansible\module_utils\distro\_distro.py,974.0
ansible.module_utils.distro._distro.LinuxDistribution.distro_release_attr,1072,5,0,5,0,0,0,8.0,2.0,0.0,D:\BaiduNetdiskDownload\graduation_project\project_folder\ansible\module_utils\distro\_distro.py,1072.0
ansible.module_utils.distro._distro.LinuxDistribution.distro_release_info,1029,1,0,1,0,0,0,9.0,1.0,0.0,D:\BaiduNetdiskDownload\graduation_project\project_folder\ansible\module_utils\distro\_distro.py,1029.0
ansible.module_utils.distro._distro.LinuxDistribution.id,833,10,6,4,6,0,0,27.0,1.0,2.0,D:\BaiduNetdiskDownload\graduation_project\project_folder\ansible\module_utils\distro\_distro.py,833.0
ansible.module_utils.distro._distro.LinuxDistribution.info,991,9,7,2,7,0,0,18.0,1.0,0.0,D:\BaiduNetdiskDownload\graduation_project\project_folder\ansible\module_utils\distro\_distro.py,991.0
ansible.module_utils.distro._distro.LinuxDistribution.like,966,4,1,3,1,0,0,7.0,1.0,0.0,D:\BaiduNetdiskDownload\graduation_project\project_folder\ansible\module_utils\distro\_distro.py,966.0
ansible.module_utils.distro._distro.LinuxDistribution.linux_distribution,817,5,4,1,4,0,0,15.0,1.0,0.0,D:\BaiduNetdiskDownload\graduation_project\project_folder\ansible\module_utils\distro\_distro.py,817.0
ansible.module_utils.distro._distro.LinuxDistribution.lsb_release_attr,1063,5,0,5,0,0,0,8.0,2.0,0.0,D:\BaiduNetdiskDownload\graduation_project\project_folder\ansible\module_utils\distro\_distro.py,1063.0
ansible.module_utils.distro._distro.LinuxDistribution.lsb_release_info,1019,1,0,1,0,0,0,9.0,1.0,0.0,D:\BaiduNetdiskDownload\graduation_project\project_folder\ansible\module_utils\distro\_distro.py,1019.0
ansible.module_utils.distro._distro.LinuxDistribution.major_version,942,3,1,2,1,0,0,7.0,1.0,0.0,D:\BaiduNetdiskDownload\graduation_project\project_folder\ansible\module_utils\distro\_distro.py,942.0
ansible.module_utils.distro._distro.LinuxDistribution.minor_version,950,3,1,2,1,0,0,7.0,1.0,0.0,D:\BaiduNetdiskDownload\graduation_project\project_folder\ansible\module_utils\distro\_distro.py,950.0
ansible.module_utils.distro._distro.LinuxDistribution.name,861,8,5,3,5,0,0,22.0,1.0,0.0,D:\BaiduNetdiskDownload\graduation_project\project_folder\ansible\module_utils\distro\_distro.py,861.0
ansible.module_utils.distro._distro.LinuxDistribution.os_release_attr,1054,5,0,5,0,0,0,8.0,2.0,0.0,D:\BaiduNetdiskDownload\graduation_project\project_folder\ansible\module_utils\distro\_distro.py,1054.0
ansible.module_utils.distro._distro.LinuxDistribution.os_release_info,1010,1,0,1,0,0,0,8.0,1.0,0.0,D:\BaiduNetdiskDownload\graduation_project\project_folder\ansible\module_utils\distro\_distro.py,1010.0
ansible.module_utils.distro._distro.LinuxDistribution.oslevel_info,1048,1,0,1,0,0,0,5.0,1.0,0.0,D:\BaiduNetdiskDownload\graduation_project\project_folder\ansible\module_utils\distro\_distro.py,1048.0
ansible.module_utils.distro._distro.LinuxDistribution.uname_attr,1081,4,0,4,0,0,0,8.0,2.0,0.0,D:\BaiduNetdiskDownload\graduation_project\project_folder\ansible\module_utils\distro\_distro.py,1081.0
ansible.module_utils.distro._distro.LinuxDistribution.uname_info,1039,1,0,1,0,0,0,8.0,1.0,0.0,D:\BaiduNetdiskDownload\graduation_project\project_folder\ansible\module_utils\distro\_distro.py,1039.0
ansible.module_utils.distro._distro.LinuxDistribution.version,884,18,12,6,12,0,0,41.0,1.0,0.0,D:\BaiduNetdiskDownload\graduation_project\project_folder\ansible\module_utils\distro\_distro.py,884.0
ansible.module_utils.distro._distro.LinuxDistribution.version_parts,926,7,3,4,3,0,0,15.0,1.0,0.0,D:\BaiduNetdiskDownload\graduation_project\project_folder\ansible\module_utils\distro\_distro.py,926.0
ansible.module_utils.distro._distro.build_number,417,1,1,0,1,0,0,11.0,0.0,0.0,D:\BaiduNetdiskDownload\graduation_project\project_folder\ansible\module_utils\distro\_distro.py,417.0
ansible.module_utils.distro._distro.codename,447,1,1,0,1,0,0,22.0,1.0,0.0,D:\BaiduNetdiskDownload\graduation_project\project_folder\ansible\module_utils\distro\_distro.py,447.0
ansible.module_utils.distro._distro.distro_release_attr,593,1,1,0,1,0,0,17.0,1.0,0.0,D:\BaiduNetdiskDownload\graduation_project\project_folder\ansible\module_utils\distro\_distro.py,593.0
ansible.module_utils.distro._distro.distro_release_info,536,1,1,0,1,0,0,8.0,1.0,0.0,D:\BaiduNetdiskDownload\graduation_project\project_folder\ansible\module_utils\distro\_distro.py,536.0
ansible.module_utils.distro._distro.id,204,4,1,3,1,0,0,81.0,1.0,0.0,D:\BaiduNetdiskDownload\graduation_project\project_folder\ansible\module_utils\distro\_distro.py,204.0
ansible.module_utils.distro._distro.info,471,1,1,0,1,0,0,42.0,0.0,0.0,D:\BaiduNetdiskDownload\graduation_project\project_folder\ansible\module_utils\distro\_distro.py,471.0
ansible.module_utils.distro._distro.like,430,1,1,0,1,0,0,15.0,1.0,0.0,D:\BaiduNetdiskDownload\graduation_project\project_folder\ansible\module_utils\distro\_distro.py,430.0
ansible.module_utils.distro._distro.linux_distribution,161,2,2,0,2,0,0,41.0,0.0,0.0,D:\BaiduNetdiskDownload\graduation_project\project_folder\ansible\module_utils\distro\_distro.py,161.0
ansible.module_utils.distro._distro.lsb_release_attr,573,1,1,0,1,0,0,18.0,1.0,0.0,D:\BaiduNetdiskDownload\graduation_project\project_folder\ansible\module_utils\distro\_distro.py,573.0
ansible.module_utils.distro._distro.lsb_release_info,525,1,1,0,1,0,0,9.0,1.0,0.0,D:\BaiduNetdiskDownload\graduation_project\project_folder\ansible\module_utils\distro\_distro.py,525.0
ansible.module_utils.distro._distro.main,1362,7,6,1,6,0,0,38.0,1.0,0.0,D:\BaiduNetdiskDownload\graduation_project\project_folder\ansible\module_utils\distro\_distro.py,1362.0
ansible.module_utils.distro._distro.major_version,391,1,1,0,1,0,0,11.0,0.0,0.0,D:\BaiduNetdiskDownload\graduation_project\project_folder\ansible\module_utils\distro\_distro.py,391.0
ansible.module_utils.distro._distro.minor_version,404,1,1,0,1,0,0,11.0,0.0,0.0,D:\BaiduNetdiskDownload\graduation_project\project_folder\ansible\module_utils\distro\_distro.py,404.0
ansible.module_utils.distro._distro.name,287,1,1,0,1,0,0,37.0,0.0,0.0,D:\BaiduNetdiskDownload\graduation_project\project_folder\ansible\module_utils\distro\_distro.py,287.0
ansible.module_utils.distro._distro.os_release_attr,554,1,1,0,1,0,0,17.0,1.0,0.0,D:\BaiduNetdiskDownload\graduation_project\project_folder\ansible\module_utils\distro\_distro.py,554.0
ansible.module_utils.distro._distro.os_release_info,515,1,1,0,1,0,0,8.0,1.0,0.0,D:\BaiduNetdiskDownload\graduation_project\project_folder\ansible\module_utils\distro\_distro.py,515.0
ansible.module_utils.distro._distro.uname_attr,612,1,1,0,1,0,0,15.0,1.0,0.0,D:\BaiduNetdiskDownload\graduation_project\project_folder\ansible\module_utils\distro\_distro.py,612.0
ansible.module_utils.distro._distro.uname_info,546,1,1,0,1,0,0,6.0,1.0,0.0,D:\BaiduNetdiskDownload\graduation_project\project_folder\ansible\module_utils\distro\_distro.py,546.0
ansible.module_utils.distro._distro.version,326,1,1,0,1,0,0,46.0,0.0,0.0,D:\BaiduNetdiskDownload\graduation_project\project_folder\ansible\module_utils\distro\_distro.py,326.0
ansible.module_utils.distro._distro.version_parts,374,1,1,0,1,0,0,15.0,0.0,0.0,D:\BaiduNetdiskDownload\graduation_project\project_folder\ansible\module_utils\distro\_distro.py,374.0
ansible.module_utils.errors.AnsibleValidationErrorMultiple.__init__,29,5,0,5,0,0,0,3.0,1.0,0.0,D:\BaiduNetdiskDownload\graduation_project\project_folder\ansible\module_utils\errors.py,29.0
ansible.module_utils.errors.AnsibleValidationErrorMultiple.append,52,439,1,438,1,1,1,7.0,2.0,0.0,D:\BaiduNetdiskDownload\graduation_project\project_folder\ansible\module_utils\errors.py,52.0
ansible.module_utils.errors.AnsibleValidationErrorMultiple.extend,60,122,1,121,1,1,1,3.0,2.0,0.0,D:\BaiduNetdiskDownload\graduation_project\project_folder\ansible\module_utils\errors.py,60.0
ansible.module_utils.facts.ansible_collector.AnsibleFactCollector.__init__,50,1,0,1,0,0,0,6.0,1.0,0.0,D:\BaiduNetdiskDownload\graduation_project\project_folder\ansible\module_utils\facts\ansible_collector.py,50.0
ansible.module_utils.facts.ansible_collector.AnsibleFactCollector._filter,57,5,4,1,4,0,0,19.0,3.0,0.0,D:\BaiduNetdiskDownload\graduation_project\project_folder\ansible\module_utils\facts\ansible_collector.py,57.0
ansible.module_utils.facts.ansible_collector.AnsibleFactCollector.collect,77,2,2,0,2,0,0,25.0,1.0,0.0,D:\BaiduNetdiskDownload\graduation_project\project_folder\ansible\module_utils\facts\ansible_collector.py,77.0
ansible.module_utils.facts.ansible_collector.CollectorMetaDataCollector.__init__,110,1,0,1,0,0,0,4.0,1.0,0.0,D:\BaiduNetdiskDownload\graduation_project\project_folder\ansible\module_utils\facts\ansible_collector.py,110.0
ansible.module_utils.facts.ansible_collector.get_ansible_collector,122,3,3,0,3,0,0,36.0,1.0,0.0,D:\BaiduNetdiskDownload\graduation_project\project_folder\ansible\module_utils\facts\ansible_collector.py,122.0
ansible.module_utils.facts.collector.BaseFactCollector._transform_dict_keys,90,3,2,1,2,0,0,8.0,2.0,0.0,D:\BaiduNetdiskDownload\graduation_project\project_folder\ansible\module_utils\facts\collector.py,90.0
ansible.module_utils.facts.collector.BaseFactCollector._transform_name,85,1,0,1,0,0,0,4.0,2.0,0.0,D:\BaiduNetdiskDownload\graduation_project\project_folder\ansible\module_utils\facts\collector.py,85.0
ansible.module_utils.facts.collector.BaseFactCollector.collect,107,1,0,1,0,0,0,6.0,1.0,0.0,D:\BaiduNetdiskDownload\graduation_project\project_folder\ansible\module_utils\facts\collector.py,100.0
ansible.module_utils.facts.collector.BaseFactCollector.collect_with_namespace,100,3,2,1,2,0,0,6.0,1.0,0.0,D:\BaiduNetdiskDownload\graduation_project\project_folder\ansible\module_utils\facts\collector.py,100.0
ansible.module_utils.facts.collector.BaseFactCollector.platform_match,80,1,0,1,0,0,0,4.0,2.0,0.0,D:\BaiduNetdiskDownload\graduation_project\project_folder\ansible\module_utils\facts\collector.py,80.0
ansible.module_utils.facts.collector._get_requires_by_collector_name,255,1,0,1,0,0,0,10.0,2.0,0.0,D:\BaiduNetdiskDownload\graduation_project\project_folder\ansible\module_utils\facts\collector.py,255.0
ansible.module_utils.facts.collector._solve_deps,331,3,2,1,2,0,0,13.0,2.0,0.0,D:\BaiduNetdiskDownload\graduation_project\project_folder\ansible\module_utils\facts\collector.py,331.0
ansible.module_utils.facts.collector.build_dep_data,298,2,1,1,1,0,0,9.0,2.0,0.0,D:\BaiduNetdiskDownload\graduation_project\project_folder\ansible\module_utils\facts\collector.py,298.0
ansible.module_utils.facts.collector.build_fact_id_to_collector_map,224,3,2,1,2,0,0,14.0,1.0,0.0,D:\BaiduNetdiskDownload\graduation_project\project_folder\ansible\module_utils\facts\collector.py,224.0
ansible.module_utils.facts.collector.collector_classes_from_gather_subset,346,7,7,0,7,0,0,56.0,0.0,0.0,D:\BaiduNetdiskDownload\graduation_project\project_folder\ansible\module_utils\facts\collector.py,346.0
ansible.module_utils.facts.collector.find_collectors_for_platform,200,3,2,1,2,0,0,22.0,2.0,0.0,D:\BaiduNetdiskDownload\graduation_project\project_folder\ansible\module_utils\facts\collector.py,200.0
ansible.module_utils.facts.collector.find_unresolved_requires,267,3,2,1,2,0,0,15.0,2.0,0.0,D:\BaiduNetdiskDownload\graduation_project\project_folder\ansible\module_utils\facts\collector.py,267.0
ansible.module_utils.facts.collector.get_collector_names,121,5,4,1,4,0,0,77.0,0.0,0.0,D:\BaiduNetdiskDownload\graduation_project\project_folder\ansible\module_utils\facts\collector.py,121.0
ansible.module_utils.facts.collector.resolve_requires,284,4,3,1,3,0,0,12.0,2.0,0.0,D:\BaiduNetdiskDownload\graduation_project\project_folder\ansible\module_utils\facts\collector.py,284.0
ansible.module_utils.facts.collector.select_collector_classes,240,3,2,1,2,0,0,13.0,2.0,0.0,D:\BaiduNetdiskDownload\graduation_project\project_folder\ansible\module_utils\facts\collector.py,240.0
ansible.module_utils.facts.collector.tsort,309,3,2,1,2,0,0,20.0,1.0,0.0,D:\BaiduNetdiskDownload\graduation_project\project_folder\ansible\module_utils\facts\collector.py,309.0
ansible.module_utils.facts.compat.ansible_facts,48,2,1,1,1,0,0,39.0,1.0,0.0,D:\BaiduNetdiskDownload\graduation_project\project_folder\ansible\module_utils\facts\compat.py,48.0
ansible.module_utils.facts.compat.get_all_facts,36,1,1,0,1,0,0,10.0,1.0,0.0,D:\BaiduNetdiskDownload\graduation_project\project_folder\ansible\module_utils\facts\compat.py,36.0
ansible.module_utils.facts.hardware.aix.AIXHardware.get_cpu_facts,58,4,3,1,3,0,0,40.0,1.0,0.0,D:\BaiduNetdiskDownload\graduation_project\project_folder\ansible\module_utils\facts\hardware\aix.py,58.0
ansible.module_utils.facts.hardware.aix.AIXHardware.get_device_facts,231,5,4,1,4,0,0,30.0,1.0,0.0,D:\BaiduNetdiskDownload\graduation_project\project_folder\ansible\module_utils\facts\hardware\aix.py,231.0
ansible.module_utils.facts.hardware.aix.AIXHardware.get_dmi_facts,126,5,4,1,4,0,0,19.0,1.0,0.0,D:\BaiduNetdiskDownload\graduation_project\project_folder\ansible\module_utils\facts\hardware\aix.py,126.0
ansible.module_utils.facts.hardware.aix.AIXHardware.get_memory_facts,99,5,4,1,4,0,0,26.0,1.0,0.0,D:\BaiduNetdiskDownload\graduation_project\project_folder\ansible\module_utils\facts\hardware\aix.py,99.0
ansible.module_utils.facts.hardware.aix.AIXHardware.get_mount_facts,188,5,4,1,4,0,0,42.0,1.0,0.0,D:\BaiduNetdiskDownload\graduation_project\project_folder\ansible\module_utils\facts\hardware\aix.py,188.0
ansible.module_utils.facts.hardware.aix.AIXHardware.get_vgs_facts,146,3,2,1,2,0,0,41.0,1.0,0.0,D:\BaiduNetdiskDownload\graduation_project\project_folder\ansible\module_utils\facts\hardware\aix.py,146.0
ansible.module_utils.facts.hardware.aix.AIXHardware.populate,39,6,6,0,6,0,0,18.0,1.0,0.0,D:\BaiduNetdiskDownload\graduation_project\project_folder\ansible\module_utils\facts\hardware\aix.py,39.0
ansible.module_utils.facts.hardware.darwin.DarwinHardware.get_cpu_facts,78,2,1,1,1,0,0,12.0,1.0,0.0,D:\BaiduNetdiskDownload\graduation_project\project_folder\ansible\module_utils\facts\hardware\darwin.py,78.0
ansible.module_utils.facts.hardware.darwin.DarwinHardware.get_mac_facts,68,4,3,1,3,0,0,9.0,1.0,0.0,D:\BaiduNetdiskDownload\graduation_project\project_folder\ansible\module_utils\facts\hardware\darwin.py,68.0
ansible.module_utils.facts.hardware.darwin.DarwinHardware.get_memory_facts,91,8,7,1,7,0,0,41.0,1.0,0.0,D:\BaiduNetdiskDownload\graduation_project\project_folder\ansible\module_utils\facts\hardware\darwin.py,91.0
ansible.module_utils.facts.hardware.darwin.DarwinHardware.get_system_profile,57,6,5,1,5,0,0,10.0,1.0,0.0,D:\BaiduNetdiskDownload\graduation_project\project_folder\ansible\module_utils\facts\hardware\darwin.py,57.0
ansible.module_utils.facts.hardware.darwin.DarwinHardware.get_uptime_facts,133,2,1,1,1,0,0,21.0,1.0,0.0,D:\BaiduNetdiskDownload\graduation_project\project_folder\ansible\module_utils\facts\hardware\darwin.py,133.0
ansible.module_utils.facts.hardware.darwin.DarwinHardware.populate,41,5,5,0,5,0,0,15.0,1.0,0.0,D:\BaiduNetdiskDownload\graduation_project\project_folder\ansible\module_utils\facts\hardware\darwin.py,41.0
ansible.module_utils.facts.hardware.freebsd.FreeBSDHardware.get_cpu_facts,70,7,6,1,6,0,0,23.0,1.0,0.0,D:\BaiduNetdiskDownload\graduation_project\project_folder\ansible\module_utils\facts\hardware\freebsd.py,70.0
ansible.module_utils.facts.hardware.freebsd.FreeBSDHardware.get_device_facts,171,3,2,1,2,0,0,18.0,1.0,0.0,D:\BaiduNetdiskDownload\graduation_project\project_folder\ansible\module_utils\facts\hardware\freebsd.py,171.0
ansible.module_utils.facts.hardware.freebsd.FreeBSDHardware.get_dmi_facts,190,6,5,1,5,0,0,46.0,1.0,0.0,D:\BaiduNetdiskDownload\graduation_project\project_folder\ansible\module_utils\facts\hardware\freebsd.py,190.0
ansible.module_utils.facts.hardware.freebsd.FreeBSDHardware.get_memory_facts,94,5,4,1,4,0,0,33.0,1.0,0.0,D:\BaiduNetdiskDownload\graduation_project\project_folder\ansible\module_utils\facts\hardware\freebsd.py,94.0
ansible.module_utils.facts.hardware.freebsd.FreeBSDHardware.get_mount_facts,151,8,7,1,7,0,0,19.0,1.0,0.0,D:\BaiduNetdiskDownload\graduation_project\project_folder\ansible\module_utils\facts\hardware\freebsd.py,151.0
ansible.module_utils.facts.hardware.freebsd.FreeBSDHardware.get_uptime_facts,128,2,1,1,1,0,0,21.0,1.0,0.0,D:\BaiduNetdiskDownload\graduation_project\project_folder\ansible\module_utils\facts\hardware\freebsd.py,128.0
ansible.module_utils.facts.hardware.freebsd.FreeBSDHardware.populate,46,6,6,0,6,0,0,23.0,1.0,0.0,D:\BaiduNetdiskDownload\graduation_project\project_folder\ansible\module_utils\facts\hardware\freebsd.py,46.0
ansible.module_utils.facts.hardware.hpux.HPUXHardware.get_cpu_facts,53,5,4,1,4,0,0,51.0,1.0,0.0,D:\BaiduNetdiskDownload\graduation_project\project_folder\ansible\module_utils\facts\hardware\hpux.py,53.0
ansible.module_utils.facts.hardware.hpux.HPUXHardware.get_hw_facts,141,4,3,1,3,0,0,17.0,1.0,0.0,D:\BaiduNetdiskDownload\graduation_project\project_folder\ansible\module_utils\facts\hardware\hpux.py,141.0
ansible.module_utils.facts.hardware.hpux.HPUXHardware.get_memory_facts,105,6,5,1,5,0,0,35.0,1.0,0.0,D:\BaiduNetdiskDownload\graduation_project\project_folder\ansible\module_utils\facts\hardware\hpux.py,105.0
ansible.module_utils.facts.hardware.hpux.HPUXHardware.populate,40,3,3,0,3,0,0,12.0,1.0,0.0,D:\BaiduNetdiskDownload\graduation_project\project_folder\ansible\module_utils\facts\hardware\hpux.py,40.0
ansible.module_utils.facts.hardware.hurd.HurdHardware.populate,32,3,3,0,3,0,0,16.0,1.0,0.0,D:\BaiduNetdiskDownload\graduation_project\project_folder\ansible\module_utils\facts\hardware\hurd.py,32.0
ansible.module_utils.facts.hardware.linux.LinuxHardware._find_bind_mounts,510,6,5,1,5,0,0,22.0,1.0,0.0,D:\BaiduNetdiskDownload\graduation_project\project_folder\ansible\module_utils\facts\hardware\linux.py,510.0
ansible.module_utils.facts.hardware.linux.LinuxHardware._find_mapper_device_name,847,4,3,1,3,0,0,10.0,2.0,0.0,D:\BaiduNetdiskDownload\graduation_project\project_folder\ansible\module_utils\facts\hardware\linux.py,847.0
ansible.module_utils.facts.hardware.linux.LinuxHardware._get_sg_inq_serial,692,2,1,1,1,0,0,7.0,3.0,0.0,D:\BaiduNetdiskDownload\graduation_project\project_folder\ansible\module_utils\facts\hardware\linux.py,692.0
ansible.module_utils.facts.hardware.linux.LinuxHardware._lsblk_uuid,449,5,4,1,4,0,0,29.0,1.0,0.0,D:\BaiduNetdiskDownload\graduation_project\project_folder\ansible\module_utils\facts\hardware\linux.py,449.0
ansible.module_utils.facts.hardware.linux.LinuxHardware._mtab_entries,533,5,4,1,4,0,0,13.0,1.0,0.0,D:\BaiduNetdiskDownload\graduation_project\project_folder\ansible\module_utils\facts\hardware\linux.py,533.0
ansible.module_utils.facts.hardware.linux.LinuxHardware._replace_octal_escapes,552,1,0,1,0,0,0,3.0,1.0,0.0,D:\BaiduNetdiskDownload\graduation_project\project_folder\ansible\module_utils\facts\hardware\linux.py,548.0
ansible.module_utils.facts.hardware.linux.LinuxHardware._run_findmnt,504,2,1,1,1,0,0,5.0,2.0,0.0,D:\BaiduNetdiskDownload\graduation_project\project_folder\ansible\module_utils\facts\hardware\linux.py,504.0
ansible.module_utils.facts.hardware.linux.LinuxHardware._run_lsblk,439,2,1,1,1,0,0,9.0,2.0,0.0,D:\BaiduNetdiskDownload\graduation_project\project_folder\ansible\module_utils\facts\hardware\linux.py,439.0
ansible.module_utils.facts.hardware.linux.LinuxHardware._udevadm_uuid,479,2,1,1,1,0,0,24.0,2.0,0.0,D:\BaiduNetdiskDownload\graduation_project\project_folder\ansible\module_utils\facts\hardware\linux.py,479.0
ansible.module_utils.facts.hardware.linux.LinuxHardware.get_all_device_links,672,3,2,1,2,0,0,7.0,1.0,0.0,D:\BaiduNetdiskDownload\graduation_project\project_folder\ansible\module_utils\facts\hardware\linux.py,672.0
ansible.module_utils.facts.hardware.linux.LinuxHardware.get_all_device_owners,660,4,3,1,3,0,0,11.0,1.0,0.0,D:\BaiduNetdiskDownload\graduation_project\project_folder\ansible\module_utils\facts\hardware\linux.py,660.0
ansible.module_utils.facts.hardware.linux.LinuxHardware.get_cpu_facts,162,9,8,1,8,0,0,153.0,1.0,0.0,D:\BaiduNetdiskDownload\graduation_project\project_folder\ansible\module_utils\facts\hardware\linux.py,162.0
ansible.module_utils.facts.hardware.linux.LinuxHardware.get_device_facts,700,10,9,1,9,0,0,137.0,1.0,0.0,D:\BaiduNetdiskDownload\graduation_project\project_folder\ansible\module_utils\facts\hardware\linux.py,700.0
ansible.module_utils.facts.hardware.linux.LinuxHardware.get_device_links,645,3,2,1,2,0,0,14.0,2.0,0.0,D:\BaiduNetdiskDownload\graduation_project\project_folder\ansible\module_utils\facts\hardware\linux.py,645.0
ansible.module_utils.facts.hardware.linux.LinuxHardware.get_dmi_facts,316,7,6,1,6,0,0,98.0,1.0,0.0,D:\BaiduNetdiskDownload\graduation_project\project_folder\ansible\module_utils\facts\hardware\linux.py,316.0
ansible.module_utils.facts.hardware.linux.LinuxHardware.get_holders,680,4,3,1,3,0,0,11.0,3.0,0.0,D:\BaiduNetdiskDownload\graduation_project\project_folder\ansible\module_utils\facts\hardware\linux.py,680.0
ansible.module_utils.facts.hardware.linux.LinuxHardware.get_lvm_facts,858,6,5,1,5,0,0,45.0,1.0,0.0,D:\BaiduNetdiskDownload\graduation_project\project_folder\ansible\module_utils\facts\hardware\linux.py,858.0
ansible.module_utils.facts.hardware.linux.LinuxHardware.get_memory_facts,116,6,4,2,4,0,0,45.0,1.0,0.0,D:\BaiduNetdiskDownload\graduation_project\project_folder\ansible\module_utils\facts\hardware\linux.py,116.0
ansible.module_utils.facts.hardware.linux.LinuxHardware.get_mount_facts,566,10,8,2,8,0,0,78.0,1.0,0.0,D:\BaiduNetdiskDownload\graduation_project\project_folder\ansible\module_utils\facts\hardware\linux.py,566.0
ansible.module_utils.facts.hardware.linux.LinuxHardware.get_mount_info,555,2,2,0,2,0,0,10.0,4.0,0.0,D:\BaiduNetdiskDownload\graduation_project\project_folder\ansible\module_utils\facts\hardware\linux.py,555.0
ansible.module_utils.facts.hardware.linux.LinuxHardware.get_sysinfo_facts,415,3,2,1,2,0,0,23.0,1.0,0.0,D:\BaiduNetdiskDownload\graduation_project\project_folder\ansible\module_utils\facts\hardware\linux.py,415.0
ansible.module_utils.facts.hardware.linux.LinuxHardware.get_uptime_facts,838,4,2,2,2,0,0,8.0,1.0,0.0,D:\BaiduNetdiskDownload\graduation_project\project_folder\ansible\module_utils\facts\hardware\linux.py,838.0
ansible.module_utils.facts.hardware.linux.LinuxHardware.populate,86,9,9,0,9,0,0,29.0,1.0,0.0,D:\BaiduNetdiskDownload\graduation_project\project_folder\ansible\module_utils\facts\hardware\linux.py,86.0
ansible.module_utils.facts.hardware.linux.get_partition_uuid,42,1,0,1,0,0,0,12.0,1.0,0.0,D:\BaiduNetdiskDownload\graduation_project\project_folder\ansible\module_utils\facts\hardware\linux.py,42.0
ansible.module_utils.facts.hardware.netbsd.NetBSDHardware.get_cpu_facts,70,6,5,1,5,0,0,33.0,1.0,0.0,D:\BaiduNetdiskDownload\graduation_project\project_folder\ansible\module_utils\facts\hardware\netbsd.py,70.0
ansible.module_utils.facts.hardware.netbsd.NetBSDHardware.get_dmi_facts,140,1,0,1,0,0,0,21.0,1.0,0.0,D:\BaiduNetdiskDownload\graduation_project\project_folder\ansible\module_utils\facts\hardware\netbsd.py,140.0
ansible.module_utils.facts.hardware.netbsd.NetBSDHardware.get_memory_facts,104,5,4,1,4,0,0,12.0,1.0,0.0,D:\BaiduNetdiskDownload\graduation_project\project_folder\ansible\module_utils\facts\hardware\netbsd.py,104.0
ansible.module_utils.facts.hardware.netbsd.NetBSDHardware.get_mount_facts,118,8,7,1,7,0,0,21.0,1.0,0.0,D:\BaiduNetdiskDownload\graduation_project\project_folder\ansible\module_utils\facts\hardware\netbsd.py,118.0
ansible.module_utils.facts.hardware.netbsd.NetBSDHardware.get_uptime_facts,162,4,3,1,3,0,0,17.0,1.0,0.0,D:\BaiduNetdiskDownload\graduation_project\project_folder\ansible\module_utils\facts\hardware\netbsd.py,162.0
ansible.module_utils.facts.hardware.netbsd.NetBSDHardware.populate,47,6,6,0,6,0,0,22.0,1.0,0.0,D:\BaiduNetdiskDownload\graduation_project\project_folder\ansible\module_utils\facts\hardware\netbsd.py,47.0
ansible.module_utils.facts.hardware.openbsd.OpenBSDHardware.get_device_facts,150,3,2,1,2,0,0,7.0,1.0,0.0,D:\BaiduNetdiskDownload\graduation_project\project_folder\ansible\module_utils\facts\hardware\openbsd.py,150.0
ansible.module_utils.facts.hardware.openbsd.OpenBSDHardware.get_dmi_facts,158,1,0,1,0,0,0,21.0,1.0,0.0,D:\BaiduNetdiskDownload\graduation_project\project_folder\ansible\module_utils\facts\hardware\openbsd.py,158.0
ansible.module_utils.facts.hardware.openbsd.OpenBSDHardware.get_memory_facts,87,6,5,1,5,0,0,25.0,1.0,0.0,D:\BaiduNetdiskDownload\graduation_project\project_folder\ansible\module_utils\facts\hardware\openbsd.py,87.0
ansible.module_utils.facts.hardware.openbsd.OpenBSDHardware.get_mount_facts,66,8,7,1,7,0,0,20.0,1.0,0.0,D:\BaiduNetdiskDownload\graduation_project\project_folder\ansible\module_utils\facts\hardware\openbsd.py,66.0
ansible.module_utils.facts.hardware.openbsd.OpenBSDHardware.get_processor_facts,131,2,1,1,1,0,0,18.0,1.0,0.0,D:\BaiduNetdiskDownload\graduation_project\project_folder\ansible\module_utils\facts\hardware\openbsd.py,131.0
ansible.module_utils.facts.hardware.openbsd.OpenBSDHardware.get_uptime_facts,113,4,3,1,3,0,0,17.0,1.0,0.0,D:\BaiduNetdiskDownload\graduation_project\project_folder\ansible\module_utils\facts\hardware\openbsd.py,113.0
ansible.module_utils.facts.hardware.openbsd.OpenBSDHardware.populate,47,7,7,0,7,0,0,17.0,1.0,0.0,D:\BaiduNetdiskDownload\graduation_project\project_folder\ansible\module_utils\facts\hardware\openbsd.py,47.0
ansible.module_utils.facts.hardware.sunos.SunOSHardware.get_cpu_facts,66,7,6,1,6,0,0,54.0,1.0,0.0,D:\BaiduNetdiskDownload\graduation_project\project_folder\ansible\module_utils\facts\hardware\sunos.py,66.0
ansible.module_utils.facts.hardware.sunos.SunOSHardware.get_device_facts,203,7,6,1,6,0,0,60.0,1.0,0.0,D:\BaiduNetdiskDownload\graduation_project\project_folder\ansible\module_utils\facts\hardware\sunos.py,203.0
ansible.module_utils.facts.hardware.sunos.SunOSHardware.get_dmi_facts,167,5,4,1,4,0,0,35.0,1.0,0.0,D:\BaiduNetdiskDownload\graduation_project\project_folder\ansible\module_utils\facts\hardware\sunos.py,167.0
ansible.module_utils.facts.hardware.sunos.SunOSHardware.get_memory_facts,121,4,3,1,3,0,0,22.0,1.0,0.0,D:\BaiduNetdiskDownload\graduation_project\project_folder\ansible\module_utils\facts\hardware\sunos.py,121.0
ansible.module_utils.facts.hardware.sunos.SunOSHardware.get_mount_facts,145,6,5,1,5,0,0,21.0,1.0,0.0,D:\BaiduNetdiskDownload\graduation_project\project_folder\ansible\module_utils\facts\hardware\sunos.py,145.0
ansible.module_utils.facts.hardware.sunos.SunOSHardware.get_uptime_facts,264,3,2,1,2,0,0,13.0,1.0,0.0,D:\BaiduNetdiskDownload\graduation_project\project_folder\ansible\module_utils\facts\hardware\sunos.py,264.0
ansible.module_utils.facts.hardware.sunos.SunOSHardware.populate,36,7,7,0,7,0,0,29.0,1.0,0.0,D:\BaiduNetdiskDownload\graduation_project\project_folder\ansible\module_utils\facts\hardware\sunos.py,36.0
ansible.module_utils.facts.namespace.FactNamespace._underscore,39,2,1,1,1,0,0,2.0,2.0,0.0,D:\BaiduNetdiskDownload\graduation_project\project_folder\ansible\module_utils\facts\namespace.py,39.0
ansible.module_utils.facts.namespace.PrefixFactNamespace.__init__,44,4,0,4,0,0,0,3.0,2.0,0.0,D:\BaiduNetdiskDownload\graduation_project\project_folder\ansible\module_utils\facts\namespace.py,44.0
ansible.module_utils.facts.namespace.PrefixFactNamespace.transform,48,1,1,0,1,0,0,3.0,2.0,0.0,D:\BaiduNetdiskDownload\graduation_project\project_folder\ansible\module_utils\facts\namespace.py,48.0
ansible.module_utils.facts.network.aix.AIXNetwork.get_default_interfaces,31,3,3,0,3,0,0,20.0,2.0,0.0,D:\BaiduNetdiskDownload\graduation_project\project_folder\ansible\module_utils\facts\network\aix.py,31.0
ansible.module_utils.facts.network.aix.AIXNetwork.get_interfaces_info,53,14,14,0,14,0,0,79.0,2.0,0.0,D:\BaiduNetdiskDownload\graduation_project\project_folder\ansible\module_utils\facts\network\aix.py,53.0
ansible.module_utils.facts.network.aix.AIXNetwork.parse_interface_line,134,2,1,1,1,0,0,6.0,2.0,0.0,D:\BaiduNetdiskDownload\graduation_project\project_folder\ansible\module_utils\facts\network\aix.py,134.0
ansible.module_utils.facts.network.darwin.DarwinNetwork.parse_media_line,30,1,1,0,1,0,0,14.0,4.0,0.0,D:\BaiduNetdiskDownload\graduation_project\project_folder\ansible\module_utils\facts\network\darwin.py,30.0
ansible.module_utils.facts.network.fc_wwn.FcWwnInitiatorFactCollector.collect,33,7,7,0,7,0,0,74.0,1.0,0.0,D:\BaiduNetdiskDownload\graduation_project\project_folder\ansible\module_utils\facts\network\fc_wwn.py,33.0
ansible.module_utils.facts.network.generic_bsd.GenericBsdIfconfigNetwork.detect_type_media,65,2,1,1,1,0,0,6.0,2.0,0.0,D:\BaiduNetdiskDownload\graduation_project\project_folder\ansible\module_utils\facts\network\generic_bsd.py,65.0
ansible.module_utils.facts.network.generic_bsd.GenericBsdIfconfigNetwork.get_default_interfaces,72,5,4,1,4,0,0,37.0,2.0,0.0,D:\BaiduNetdiskDownload\graduation_project\project_folder\ansible\module_utils\facts\network\generic_bsd.py,72.0
ansible.module_utils.facts.network.generic_bsd.GenericBsdIfconfigNetwork.get_interfaces_info,110,16,15,1,15,0,0,44.0,2.0,0.0,D:\BaiduNetdiskDownload\graduation_project\project_folder\ansible\module_utils\facts\network\generic_bsd.py,110.0
ansible.module_utils.facts.network.generic_bsd.GenericBsdIfconfigNetwork.get_options,291,10,3,7,3,0,0,8.0,2.0,0.0,D:\BaiduNetdiskDownload\graduation_project\project_folder\ansible\module_utils\facts\network\generic_bsd.py,291.0
ansible.module_utils.facts.network.generic_bsd.GenericBsdIfconfigNetwork.merge_default_interface,300,1,0,1,0,0,0,21.0,4.0,0.0,D:\BaiduNetdiskDownload\graduation_project\project_folder\ansible\module_utils\facts\network\generic_bsd.py,300.0
ansible.module_utils.facts.network.generic_bsd.GenericBsdIfconfigNetwork.parse_ether_line,179,2,0,2,0,0,0,3.0,4.0,0.0,D:\BaiduNetdiskDownload\graduation_project\project_folder\ansible\module_utils\facts\network\generic_bsd.py,179.0
ansible.module_utils.facts.network.generic_bsd.GenericBsdIfconfigNetwork.parse_inet6_line,258,5,2,3,2,0,0,22.0,4.0,0.0,D:\BaiduNetdiskDownload\graduation_project\project_folder\ansible\module_utils\facts\network\generic_bsd.py,258.0
ansible.module_utils.facts.network.generic_bsd.GenericBsdIfconfigNetwork.parse_inet_line,199,7,4,3,4,0,0,58.0,4.0,0.0,D:\BaiduNetdiskDownload\graduation_project\project_folder\ansible\module_utils\facts\network\generic_bsd.py,199.0
ansible.module_utils.facts.network.generic_bsd.GenericBsdIfconfigNetwork.parse_interface_line,155,2,1,1,1,0,0,15.0,2.0,0.0,D:\BaiduNetdiskDownload\graduation_project\project_folder\ansible\module_utils\facts\network\generic_bsd.py,155.0
ansible.module_utils.facts.network.generic_bsd.GenericBsdIfconfigNetwork.parse_lladdr_line,196,3,0,3,0,0,0,2.0,4.0,0.0,D:\BaiduNetdiskDownload\graduation_project\project_folder\ansible\module_utils\facts\network\generic_bsd.py,196.0
ansible.module_utils.facts.network.generic_bsd.GenericBsdIfconfigNetwork.parse_media_line,183,4,1,3,1,0,0,9.0,4.0,0.0,D:\BaiduNetdiskDownload\graduation_project\project_folder\ansible\module_utils\facts\network\generic_bsd.py,183.0
ansible.module_utils.facts.network.generic_bsd.GenericBsdIfconfigNetwork.parse_nd6_line,175,4,1,3,1,0,0,3.0,4.0,0.0,D:\BaiduNetdiskDownload\graduation_project\project_folder\ansible\module_utils\facts\network\generic_bsd.py,175.0
ansible.module_utils.facts.network.generic_bsd.GenericBsdIfconfigNetwork.parse_options_line,171,4,1,3,1,0,0,3.0,4.0,0.0,D:\BaiduNetdiskDownload\graduation_project\project_folder\ansible\module_utils\facts\network\generic_bsd.py,171.0
ansible.module_utils.facts.network.generic_bsd.GenericBsdIfconfigNetwork.parse_status_line,193,3,0,3,0,0,0,2.0,4.0,0.0,D:\BaiduNetdiskDownload\graduation_project\project_folder\ansible\module_utils\facts\network\generic_bsd.py,193.0
ansible.module_utils.facts.network.generic_bsd.GenericBsdIfconfigNetwork.parse_tunnel_line,281,1,0,1,0,0,0,2.0,4.0,0.0,D:\BaiduNetdiskDownload\graduation_project\project_folder\ansible\module_utils\facts\network\generic_bsd.py,281.0
ansible.module_utils.facts.network.generic_bsd.GenericBsdIfconfigNetwork.parse_unknown_line,284,3,0,3,0,0,0,4.0,4.0,0.0,D:\BaiduNetdiskDownload\graduation_project\project_folder\ansible\module_utils\facts\network\generic_bsd.py,284.0
ansible.module_utils.facts.network.generic_bsd.GenericBsdIfconfigNetwork.populate,35,4,4,0,4,0,0,29.0,1.0,0.0,D:\BaiduNetdiskDownload\graduation_project\project_folder\ansible\module_utils\facts\network\generic_bsd.py,35.0
ansible.module_utils.facts.network.hpux.HPUXNetwork.get_default_interfaces,47,4,3,1,3,0,0,12.0,1.0,0.0,D:\BaiduNetdiskDownload\graduation_project\project_folder\ansible\module_utils\facts\network\hpux.py,47.0
ansible.module_utils.facts.network.hpux.HPUXNetwork.get_interfaces_info,60,4,3,1,3,0,0,17.0,1.0,0.0,D:\BaiduNetdiskDownload\graduation_project\project_folder\ansible\module_utils\facts\network\hpux.py,60.0
ansible.module_utils.facts.network.hpux.HPUXNetwork.populate,30,2,2,0,2,0,0,16.0,1.0,0.0,D:\BaiduNetdiskDownload\graduation_project\project_folder\ansible\module_utils\facts\network\hpux.py,30.0
ansible.module_utils.facts.network.hurd.HurdPfinetNetwork.assign_network_facts,31,5,4,1,4,0,0,31.0,4.0,0.0,D:\BaiduNetdiskDownload\graduation_project\project_folder\ansible\module_utils\facts\network\hurd.py,31.0
ansible.module_utils.facts.network.hurd.HurdPfinetNetwork.populate,63,1,1,0,1,0,0,19.0,1.0,0.0,D:\BaiduNetdiskDownload\graduation_project\project_folder\ansible\module_utils\facts\network\hurd.py,63.0
ansible.module_utils.facts.network.iscsi.IscsiInitiatorNetworkCollector.collect,33,9,9,0,9,0,0,75.0,1.0,0.0,D:\BaiduNetdiskDownload\graduation_project\project_folder\ansible\module_utils\facts\network\iscsi.py,33.0
ansible.module_utils.facts.network.iscsi.IscsiInitiatorNetworkCollector.findstr,109,2,1,1,1,0,0,5.0,3.0,0.0,D:\BaiduNetdiskDownload\graduation_project\project_folder\ansible\module_utils\facts\network\iscsi.py,109.0
ansible.module_utils.facts.network.linux.LinuxNetwork.get_default_interfaces,101,5,4,1,4,0,0,34.0,2.0,0.0,D:\BaiduNetdiskDownload\graduation_project\project_folder\ansible\module_utils\facts\network\linux.py,101.0
ansible.module_utils.facts.network.linux.LinuxNetwork.get_ethtool_data,329,9,8,1,8,0,0,30.0,2.0,0.0,D:\BaiduNetdiskDownload\graduation_project\project_folder\ansible\module_utils\facts\network\linux.py,329.0
ansible.module_utils.facts.network.linux.LinuxNetwork.get_interfaces_info,136,9,8,1,8,0,0,192.0,4.0,0.0,D:\BaiduNetdiskDownload\graduation_project\project_folder\ansible\module_utils\facts\network\linux.py,136.0
ansible.module_utils.facts.network.linux.LinuxNetwork.get_locally_reachable_ips,69,5,4,1,4,0,0,31.0,2.0,2.0,D:\BaiduNetdiskDownload\graduation_project\project_folder\ansible\module_utils\facts\network\linux.py,69.0
ansible.module_utils.facts.network.linux.LinuxNetwork.populate,46,3,3,0,3,0,0,17.0,1.0,0.0,D:\BaiduNetdiskDownload\graduation_project\project_folder\ansible\module_utils\facts\network\linux.py,46.0
ansible.module_utils.facts.network.netbsd.NetBSDNetwork.parse_media_line,29,1,1,0,1,0,0,14.0,4.0,0.0,D:\BaiduNetdiskDownload\graduation_project\project_folder\ansible\module_utils\facts\network\netbsd.py,29.0
ansible.module_utils.facts.network.nvme.NvmeInitiatorNetworkCollector.collect,32,4,4,0,4,0,0,24.0,1.0,0.0,D:\BaiduNetdiskDownload\graduation_project\project_folder\ansible\module_utils\facts\network\nvme.py,32.0
ansible.module_utils.facts.network.sunos.SunOSNetwork.get_interfaces_info,38,14,14,0,14,0,0,48.0,2.0,0.0,D:\BaiduNetdiskDownload\graduation_project\project_folder\ansible\module_utils\facts\network\sunos.py,38.0
ansible.module_utils.facts.network.sunos.SunOSNetwork.parse_ether_line,105,2,1,1,1,0,0,6.0,4.0,0.0,D:\BaiduNetdiskDownload\graduation_project\project_folder\ansible\module_utils\facts\network\sunos.py,105.0
ansible.module_utils.facts.network.sunos.SunOSNetwork.parse_interface_line,87,3,2,1,2,0,0,15.0,4.0,0.0,D:\BaiduNetdiskDownload\graduation_project\project_folder\ansible\module_utils\facts\network\sunos.py,87.0
ansible.module_utils.facts.other.facter.FacterFactCollector.__init__,18,1,1,0,1,0,0,5.0,1.0,0.0,D:\BaiduNetdiskDownload\graduation_project\project_folder\ansible\module_utils\facts\other\facter.py,18.0
ansible.module_utils.facts.other.facter.FacterFactCollector.collect,58,1,1,0,1,0,0,22.0,1.0,0.0,D:\BaiduNetdiskDownload\graduation_project\project_folder\ansible\module_utils\facts\other\facter.py,58.0
ansible.module_utils.facts.other.facter.FacterFactCollector.find_facter,24,1,0,1,0,0,0,9.0,2.0,0.0,D:\BaiduNetdiskDownload\graduation_project\project_folder\ansible\module_utils\facts\other\facter.py,24.0
ansible.module_utils.facts.other.facter.FacterFactCollector.get_facter_output,46,3,2,1,2,0,0,11.0,2.0,0.0,D:\BaiduNetdiskDownload\graduation_project\project_folder\ansible\module_utils\facts\other\facter.py,46.0
ansible.module_utils.facts.other.facter.FacterFactCollector.run_facter,34,2,1,1,1,0,0,11.0,3.0,0.0,D:\BaiduNetdiskDownload\graduation_project\project_folder\ansible\module_utils\facts\other\facter.py,34.0
ansible.module_utils.facts.other.ohai.OhaiFactCollector.__init__,32,1,1,0,1,0,0,5.0,1.0,0.0,D:\BaiduNetdiskDownload\graduation_project\project_folder\ansible\module_utils\facts\other\ohai.py,32.0
ansible.module_utils.facts.other.ohai.OhaiFactCollector.collect,57,1,1,0,1,0,0,17.0,1.0,0.0,D:\BaiduNetdiskDownload\graduation_project\project_folder\ansible\module_utils\facts\other\ohai.py,57.0
ansible.module_utils.facts.other.ohai.OhaiFactCollector.find_ohai,38,1,0,1,0,0,0,3.0,2.0,0.0,D:\BaiduNetdiskDownload\graduation_project\project_folder\ansible\module_utils\facts\other\ohai.py,38.0
ansible.module_utils.facts.other.ohai.OhaiFactCollector.get_ohai_output,46,3,2,1,2,0,0,10.0,2.0,0.0,D:\BaiduNetdiskDownload\graduation_project\project_folder\ansible\module_utils\facts\other\ohai.py,46.0
ansible.module_utils.facts.other.ohai.OhaiFactCollector.run_ohai,42,2,1,1,1,0,0,3.0,3.0,0.0,D:\BaiduNetdiskDownload\graduation_project\project_folder\ansible\module_utils\facts\other\ohai.py,42.0
ansible.module_utils.facts.packages.CLIMgr.is_available,80,1,1,0,1,0,0,6.0,1.0,0.0,D:\BaiduNetdiskDownload\graduation_project\project_folder\ansible\module_utils\facts\packages.py,80.0
ansible.module_utils.facts.packages.PkgMgr.get_package_details,32,1,0,1,0,0,0,3.0,2.0,0.0,D:\BaiduNetdiskDownload\graduation_project\project_folder\ansible\module_utils\facts\packages.py,32.0
ansible.module_utils.facts.packages.PkgMgr.get_packages,36,5,4,1,4,0,0,14.0,1.0,0.0,D:\BaiduNetdiskDownload\graduation_project\project_folder\ansible\module_utils\facts\packages.py,36.0
ansible.module_utils.facts.packages.PkgMgr.list_installed,27,1,0,1,0,0,0,3.0,1.0,0.0,D:\BaiduNetdiskDownload\graduation_project\project_folder\ansible\module_utils\facts\packages.py,27.0
ansible.module_utils.facts.packages.get_all_pkg_managers,13,3,2,1,2,0,0,3.0,1.0,0.0,D:\BaiduNetdiskDownload\graduation_project\project_folder\ansible\module_utils\facts\packages.py,13.0
ansible.module_utils.facts.sysctl.get_sysctl,23,9,6,3,6,0,0,39.0,2.0,0.0,D:\BaiduNetdiskDownload\graduation_project\project_folder\ansible\module_utils\facts\sysctl.py,23.0
ansible.module_utils.facts.system.caps.SystemCapabilitiesFactCollector.collect,30,5,5,0,5,0,0,31.0,1.0,0.0,D:\BaiduNetdiskDownload\graduation_project\project_folder\ansible\module_utils\facts\system\caps.py,30.0
ansible.module_utils.facts.system.chroot.ChrootFactCollector.collect,47,1,1,0,1,0,0,2.0,1.0,0.0,D:\BaiduNetdiskDownload\graduation_project\project_folder\ansible\module_utils\facts\system\chroot.py,47.0
ansible.module_utils.facts.system.chroot.is_chroot,12,3,1,2,1,0,0,29.0,0.0,0.0,D:\BaiduNetdiskDownload\graduation_project\project_folder\ansible\module_utils\facts\system\chroot.py,12.0
ansible.module_utils.facts.system.cmdline.CmdLineFactCollector._get_proc_cmdline,31,2,1,1,1,0,0,2.0,1.0,0.0,D:\BaiduNetdiskDownload\graduation_project\project_folder\ansible\module_utils\facts\system\cmdline.py,31.0
ansible.module_utils.facts.system.cmdline.CmdLineFactCollector._parse_proc_cmdline,34,2,1,1,1,0,0,13.0,2.0,0.0,D:\BaiduNetdiskDownload\graduation_project\project_folder\ansible\module_utils\facts\system\cmdline.py,34.0
ansible.module_utils.facts.system.cmdline.CmdLineFactCollector._parse_proc_cmdline_facts,48,3,2,1,2,0,0,20.0,2.0,0.0,D:\BaiduNetdiskDownload\graduation_project\project_folder\ansible\module_utils\facts\system\cmdline.py,48.0
ansible.module_utils.facts.system.cmdline.CmdLineFactCollector.collect,69,3,3,0,3,0,0,12.0,1.0,0.0,D:\BaiduNetdiskDownload\graduation_project\project_folder\ansible\module_utils\facts\system\cmdline.py,69.0
ansible.module_utils.facts.system.date_time.DateTimeFactCollector.collect,32,3,3,0,3,0,0,38.0,1.0,0.0,D:\BaiduNetdiskDownload\graduation_project\project_folder\ansible\module_utils\facts\system\date_time.py,32.0
ansible.module_utils.facts.system.distribution.Distribution.__init__,542,1,0,1,0,0,0,2.0,2.0,0.0,D:\BaiduNetdiskDownload\graduation_project\project_folder\ansible\module_utils\facts\system\distribution.py,542.0
ansible.module_utils.facts.system.distribution.Distribution.get_distribution_AIX,579,2,2,0,2,0,0,11.0,1.0,0.0,D:\BaiduNetdiskDownload\graduation_project\project_folder\ansible\module_utils\facts\system\distribution.py,579.0
ansible.module_utils.facts.system.distribution.Distribution.get_distribution_Darwin,600,2,2,0,2,0,0,9.0,1.0,0.0,D:\BaiduNetdiskDownload\graduation_project\project_folder\ansible\module_utils\facts\system\distribution.py,600.0
ansible.module_utils.facts.system.distribution.Distribution.get_distribution_DragonFly,632,2,2,0,2,0,0,10.0,1.0,0.0,D:\BaiduNetdiskDownload\graduation_project\project_folder\ansible\module_utils\facts\system\distribution.py,632.0
ansible.module_utils.facts.system.distribution.Distribution.get_distribution_HPUX,591,2,2,0,2,0,0,8.0,1.0,0.0,D:\BaiduNetdiskDownload\graduation_project\project_folder\ansible\module_utils\facts\system\distribution.py,591.0
ansible.module_utils.facts.system.distribution.Distribution.get_distribution_NetBSD,643,3,3,0,3,0,0,13.0,1.0,0.0,D:\BaiduNetdiskDownload\graduation_project\project_folder\ansible\module_utils\facts\system\distribution.py,643.0
ansible.module_utils.facts.system.distribution.Distribution.get_distribution_OpenBSD,621,2,2,0,2,0,0,10.0,1.0,0.0,D:\BaiduNetdiskDownload\graduation_project\project_folder\ansible\module_utils\facts\system\distribution.py,621.0
ansible.module_utils.facts.system.distribution.Distribution.get_distribution_SunOS,662,9,9,0,9,0,0,45.0,1.0,0.0,D:\BaiduNetdiskDownload\graduation_project\project_folder\ansible\module_utils\facts\system\distribution.py,662.0
ansible.module_utils.facts.system.distribution.Distribution.get_distribution_facts,545,4,3,1,3,0,0,33.0,1.0,0.0,D:\BaiduNetdiskDownload\graduation_project\project_folder\ansible\module_utils\facts\system\distribution.py,545.0
ansible.module_utils.facts.system.distribution.DistributionFactCollector.collect,716,2,2,0,2,0,0,10.0,1.0,0.0,D:\BaiduNetdiskDownload\graduation_project\project_folder\ansible\module_utils\facts\system\distribution.py,716.0
ansible.module_utils.facts.system.distribution.DistributionFiles.__init__,97,1,0,1,0,0,0,2.0,2.0,0.0,D:\BaiduNetdiskDownload\graduation_project\project_folder\ansible\module_utils\facts\system\distribution.py,97.0
ansible.module_utils.facts.system.distribution.DistributionFiles._get_dist_file_content,103,3,2,1,2,0,0,7.0,2.0,0.0,D:\BaiduNetdiskDownload\graduation_project\project_folder\ansible\module_utils\facts\system\distribution.py,103.0
ansible.module_utils.facts.system.distribution.DistributionFiles._get_file_content,100,2,1,1,1,0,0,2.0,2.0,0.0,D:\BaiduNetdiskDownload\graduation_project\project_folder\ansible\module_utils\facts\system\distribution.py,100.0
ansible.module_utils.facts.system.distribution.DistributionFiles._guess_distribution,155,5,4,1,4,0,0,12.0,1.0,0.0,D:\BaiduNetdiskDownload\graduation_project\project_folder\ansible\module_utils\facts\system\distribution.py,155.0
ansible.module_utils.facts.system.distribution.DistributionFiles._parse_dist_file,111,3,2,1,2,0,0,36.0,5.0,0.0,D:\BaiduNetdiskDownload\graduation_project\project_folder\ansible\module_utils\facts\system\distribution.py,111.0
ansible.module_utils.facts.system.distribution.DistributionFiles.parse_distribution_file_Amazon,222,2,2,0,2,0,0,24.0,5.0,0.0,D:\BaiduNetdiskDownload\graduation_project\project_folder\ansible\module_utils\facts\system\distribution.py,222.0
ansible.module_utils.facts.system.distribution.DistributionFiles.parse_distribution_file_ClearLinux,468,2,2,0,2,0,0,18.0,5.0,0.0,D:\BaiduNetdiskDownload\graduation_project\project_folder\ansible\module_utils\facts\system\distribution.py,468.0
ansible.module_utils.facts.system.distribution.DistributionFiles.parse_distribution_file_Coreos,433,3,3,0,3,0,0,17.0,5.0,0.0,D:\BaiduNetdiskDownload\graduation_project\project_folder\ansible\module_utils\facts\system\distribution.py,433.0
ansible.module_utils.facts.system.distribution.DistributionFiles.parse_distribution_file_Debian,320,5,5,0,5,0,0,85.0,5.0,0.0,D:\BaiduNetdiskDownload\graduation_project\project_folder\ansible\module_utils\facts\system\distribution.py,320.0
ansible.module_utils.facts.system.distribution.DistributionFiles.parse_distribution_file_Flatcar,451,4,4,0,4,0,0,16.0,5.0,0.0,D:\BaiduNetdiskDownload\graduation_project\project_folder\ansible\module_utils\facts\system\distribution.py,451.0
ansible.module_utils.facts.system.distribution.DistributionFiles.parse_distribution_file_Mandriva,406,1,1,0,1,0,0,15.0,5.0,0.0,D:\BaiduNetdiskDownload\graduation_project\project_folder\ansible\module_utils\facts\system\distribution.py,406.0
ansible.module_utils.facts.system.distribution.DistributionFiles.parse_distribution_file_NA,422,2,2,0,2,0,0,10.0,5.0,0.0,D:\BaiduNetdiskDownload\graduation_project\project_folder\ansible\module_utils\facts\system\distribution.py,422.0
ansible.module_utils.facts.system.distribution.DistributionFiles.parse_distribution_file_OpenWrt,247,1,1,0,1,0,0,12.0,5.0,0.0,D:\BaiduNetdiskDownload\graduation_project\project_folder\ansible\module_utils\facts\system\distribution.py,247.0
ansible.module_utils.facts.system.distribution.DistributionFiles.parse_distribution_file_SUSE,266,7,7,0,7,0,0,53.0,5.0,0.0,D:\BaiduNetdiskDownload\graduation_project\project_folder\ansible\module_utils\facts\system\distribution.py,266.0
ansible.module_utils.facts.system.distribution.DistributionFiles.process_dist_files,168,4,3,1,3,0,0,42.0,1.0,0.0,D:\BaiduNetdiskDownload\graduation_project\project_folder\ansible\module_utils\facts\system\distribution.py,168.0
ansible.module_utils.facts.system.distribution._file_exists,31,2,0,2,0,0,0,15.0,1.0,0.0,D:\BaiduNetdiskDownload\graduation_project\project_folder\ansible\module_utils\facts\system\distribution.py,31.0
ansible.module_utils.facts.system.distribution.get_uname,20,4,3,1,3,0,0,9.0,1.0,0.0,D:\BaiduNetdiskDownload\graduation_project\project_folder\ansible\module_utils\facts\system\distribution.py,20.0
ansible.module_utils.facts.system.dns.DnsFactCollector.collect,29,6,6,0,6,0,0,39.0,1.0,0.0,D:\BaiduNetdiskDownload\graduation_project\project_folder\ansible\module_utils\facts\system\dns.py,29.0
ansible.module_utils.facts.system.env.EnvFactCollector.collect,31,1,1,0,1,0,0,8.0,1.0,0.0,D:\BaiduNetdiskDownload\graduation_project\project_folder\ansible\module_utils\facts\system\env.py,31.0
ansible.module_utils.facts.system.fips.FipsFactCollector.collect,31,1,1,0,1,0,0,8.0,1.0,0.0,D:\BaiduNetdiskDownload\graduation_project\project_folder\ansible\module_utils\facts\system\fips.py,31.0
ansible.module_utils.facts.system.local.LocalFactCollector.collect,36,5,5,0,5,0,0,81.0,1.0,0.0,D:\BaiduNetdiskDownload\graduation_project\project_folder\ansible\module_utils\facts\system\local.py,36.0
ansible.module_utils.facts.system.lsb.LSBFactCollector._lsb_release_bin,33,5,4,1,4,0,0,27.0,3.0,0.0,D:\BaiduNetdiskDownload\graduation_project\project_folder\ansible\module_utils\facts\system\lsb.py,33.0
ansible.module_utils.facts.system.lsb.LSBFactCollector._lsb_release_file,61,4,3,1,3,0,0,19.0,2.0,0.0,D:\BaiduNetdiskDownload\graduation_project\project_folder\ansible\module_utils\facts\system\lsb.py,61.0
ansible.module_utils.facts.system.lsb.LSBFactCollector.collect,81,5,5,0,5,0,0,27.0,1.0,0.0,D:\BaiduNetdiskDownload\graduation_project\project_folder\ansible\module_utils\facts\system\lsb.py,81.0
ansible.module_utils.facts.system.pkg_mgr.PkgMgrFactCollector._check_apt_flavor,84,2,1,1,1,0,0,16.0,2.0,0.0,D:\BaiduNetdiskDownload\graduation_project\project_folder\ansible\module_utils\facts\system\pkg_mgr.py,84.0
ansible.module_utils.facts.system.pkg_mgr.PkgMgrFactCollector._check_rh_versions,71,1,0,1,0,0,0,12.0,1.0,0.0,D:\BaiduNetdiskDownload\graduation_project\project_folder\ansible\module_utils\facts\system\pkg_mgr.py,71.0
ansible.module_utils.facts.system.pkg_mgr.PkgMgrFactCollector.collect,111,3,3,0,3,0,0,26.0,1.0,0.0,D:\BaiduNetdiskDownload\graduation_project\project_folder\ansible\module_utils\facts\system\pkg_mgr.py,111.0
ansible.module_utils.facts.system.pkg_mgr.PkgMgrFactCollector.pkg_mgrs,101,1,0,1,0,0,0,9.0,2.0,0.0,D:\BaiduNetdiskDownload\graduation_project\project_folder\ansible\module_utils\facts\system\pkg_mgr.py,101.0
ansible.module_utils.facts.system.platform.PlatformFactCollector.collect,43,7,7,0,7,0,0,56.0,1.0,0.0,D:\BaiduNetdiskDownload\graduation_project\project_folder\ansible\module_utils\facts\system\platform.py,43.0
ansible.module_utils.facts.system.service_mgr.ServiceMgrFactCollector.collect,66,7,7,0,7,0,0,88.0,1.0,0.0,D:\BaiduNetdiskDownload\graduation_project\project_folder\ansible\module_utils\facts\system\service_mgr.py,66.0
ansible.module_utils.facts.system.service_mgr.ServiceMgrFactCollector.is_systemd_managed,45,3,0,3,0,0,0,10.0,1.0,0.0,D:\BaiduNetdiskDownload\graduation_project\project_folder\ansible\module_utils\facts\system\service_mgr.py,45.0
ansible.module_utils.facts.system.service_mgr.ServiceMgrFactCollector.is_systemd_managed_offline,57,1,0,1,0,0,0,8.0,1.0,0.0,D:\BaiduNetdiskDownload\graduation_project\project_folder\ansible\module_utils\facts\system\service_mgr.py,57.0
ansible.module_utils.facts.system.ssh_pub_keys.SshPubKeyFactCollector.collect,33,2,2,0,2,0,0,23.0,1.0,0.0,D:\BaiduNetdiskDownload\graduation_project\project_folder\ansible\module_utils\facts\system\ssh_pub_keys.py,33.0
ansible.module_utils.facts.system.systemd.SystemdFactCollector.collect,30,3,3,0,3,0,0,18.0,1.0,0.0,D:\BaiduNetdiskDownload\graduation_project\project_folder\ansible\module_utils\facts\system\systemd.py,30.0
ansible.module_utils.facts.timeout.timeout,32,1,1,0,1,0,0,38.0,0.0,3.0,D:\BaiduNetdiskDownload\graduation_project\project_folder\ansible\module_utils\facts\timeout.py,32.0
ansible.module_utils.facts.utils.get_file_content,22,31,2,29,2,0,0,40.0,1.0,0.0,D:\BaiduNetdiskDownload\graduation_project\project_folder\ansible\module_utils\facts\utils.py,22.0
ansible.module_utils.facts.utils.get_file_lines,64,17,4,13,4,0,0,14.0,1.0,0.0,D:\BaiduNetdiskDownload\graduation_project\project_folder\ansible\module_utils\facts\utils.py,64.0
ansible.module_utils.facts.utils.get_mount_size,80,6,0,6,0,0,0,22.0,1.0,0.0,D:\BaiduNetdiskDownload\graduation_project\project_folder\ansible\module_utils\facts\utils.py,80.0
ansible.module_utils.facts.virtual.base.Virtual.get_virtual_facts,49,1,0,1,0,0,0,8.0,1.0,0.0,D:\BaiduNetdiskDownload\graduation_project\project_folder\ansible\module_utils\facts\virtual\base.py,49.0
ansible.module_utils.facts.virtual.base.Virtual.populate,44,1,1,0,1,0,0,4.0,1.0,0.0,D:\BaiduNetdiskDownload\graduation_project\project_folder\ansible\module_utils\facts\virtual\base.py,44.0
ansible.module_utils.facts.virtual.freebsd.FreeBSDVirtual.get_virtual_facts,32,3,3,0,3,0,0,42.0,1.0,0.0,D:\BaiduNetdiskDownload\graduation_project\project_folder\ansible\module_utils\facts\virtual\freebsd.py,32.0
ansible.module_utils.facts.virtual.hpux.HPUXVirtual.get_virtual_facts,32,2,2,0,2,0,0,35.0,1.0,0.0,D:\BaiduNetdiskDownload\graduation_project\project_folder\ansible\module_utils\facts\virtual\hpux.py,32.0
ansible.module_utils.facts.virtual.linux.LinuxVirtual.get_virtual_facts,35,12,12,0,12,0,0,365.0,1.0,0.0,D:\BaiduNetdiskDownload\graduation_project\project_folder\ansible\module_utils\facts\virtual\linux.py,35.0
ansible.module_utils.facts.virtual.netbsd.NetBSDVirtual.get_virtual_facts,27,3,3,0,3,0,0,41.0,1.0,0.0,D:\BaiduNetdiskDownload\graduation_project\project_folder\ansible\module_utils\facts\virtual\netbsd.py,27.0
ansible.module_utils.facts.virtual.openbsd.OpenBSDVirtual.get_virtual_facts,35,5,5,0,5,0,0,34.0,1.0,0.0,D:\BaiduNetdiskDownload\graduation_project\project_folder\ansible\module_utils\facts\virtual\openbsd.py,35.0
ansible.module_utils.facts.virtual.sunos.SunOSVirtual.get_virtual_facts,32,7,7,0,7,0,0,102.0,1.0,0.0,D:\BaiduNetdiskDownload\graduation_project\project_folder\ansible\module_utils\facts\virtual\sunos.py,32.0
ansible.module_utils.facts.virtual.sysctl.VirtualSysctlDetectionMixin.detect_sysctl,22,2,0,2,0,0,0,2.0,1.0,0.0,D:\BaiduNetdiskDownload\graduation_project\project_folder\ansible\module_utils\facts\virtual\sysctl.py,22.0
ansible.module_utils.facts.virtual.sysctl.VirtualSysctlDetectionMixin.detect_virt_product,25,7,4,3,4,0,0,66.0,2.0,0.0,D:\BaiduNetdiskDownload\graduation_project\project_folder\ansible\module_utils\facts\virtual\sysctl.py,25.0
ansible.module_utils.facts.virtual.sysctl.VirtualSysctlDetectionMixin.detect_virt_vendor,92,7,4,3,4,0,0,20.0,2.0,0.0,D:\BaiduNetdiskDownload\graduation_project\project_folder\ansible\module_utils\facts\virtual\sysctl.py,92.0
ansible.module_utils.json_utils._filter_non_json_lines,34,8,6,2,6,0,0,45.0,1.0,0.0,D:\BaiduNetdiskDownload\graduation_project\project_folder\ansible\module_utils\json_utils.py,34.0
ansible.module_utils.parsing.convert_bool.boolean,15,30,4,26,4,0,0,14.0,1.0,0.0,D:\BaiduNetdiskDownload\graduation_project\project_folder\ansible\module_utils\parsing\convert_bool.py,15.0
ansible.module_utils.pycompat24.__getattr__,56,1,1,0,1,0,0,15.0,1.0,0.0,D:\BaiduNetdiskDownload\graduation_project\project_folder\ansible\module_utils\pycompat24.py,56.0
ansible.module_utils.pycompat24.get_exception,36,1,1,0,1,0,0,18.0,1.0,0.0,D:\BaiduNetdiskDownload\graduation_project\project_folder\ansible\module_utils\pycompat24.py,36.0
ansible.module_utils.service.check_ps,259,2,2,0,2,0,0,18.0,2.0,0.0,D:\BaiduNetdiskDownload\graduation_project\project_folder\ansible\module_utils\service.py,259.0
ansible.module_utils.service.daemonize,164,8,7,1,7,0,0,93.0,2.0,0.0,D:\BaiduNetdiskDownload\graduation_project\project_folder\ansible\module_utils\service.py,164.0
ansible.module_utils.service.fail_if_missing,108,4,1,3,1,0,0,12.0,3.0,0.0,D:\BaiduNetdiskDownload\graduation_project\project_folder\ansible\module_utils\service.py,108.0
ansible.module_utils.service.fork_process,122,2,0,2,0,0,0,40.0,1.0,0.0,D:\BaiduNetdiskDownload\graduation_project\project_folder\ansible\module_utils\service.py,122.0
ansible.module_utils.service.get_ps,87,3,2,1,2,0,0,19.0,2.0,0.0,D:\BaiduNetdiskDownload\graduation_project\project_folder\ansible\module_utils\service.py,87.0
ansible.module_utils.service.get_sysv_script,62,3,1,2,1,0,0,13.0,1.0,0.0,D:\BaiduNetdiskDownload\graduation_project\project_folder\ansible\module_utils\service.py,62.0
ansible.module_utils.service.is_systemd_managed,279,3,1,2,1,0,0,25.0,1.0,0.0,D:\BaiduNetdiskDownload\graduation_project\project_folder\ansible\module_utils\service.py,279.0
ansible.module_utils.service.sysv_exists,77,4,1,3,1,0,0,8.0,1.0,0.0,D:\BaiduNetdiskDownload\graduation_project\project_folder\ansible\module_utils\service.py,77.0
ansible.module_utils.service.sysv_is_enabled,44,3,0,3,0,0,0,16.0,1.0,0.0,D:\BaiduNetdiskDownload\graduation_project\project_folder\ansible\module_utils\service.py,44.0
ansible.module_utils.six.__init__.MovedAttribute.__init__,155,1,0,1,0,0,0,17.0,4.0,0.0,D:\BaiduNetdiskDownload\graduation_project\project_folder\ansible\module_utils\six\__init__.py,155.0
ansible.module_utils.six.__init__.MovedAttribute._resolve,173,1,1,0,1,0,0,3.0,1.0,0.0,D:\BaiduNetdiskDownload\graduation_project\project_folder\ansible\module_utils\six\__init__.py,173.0
ansible.module_utils.six.__init__.MovedModule.__getattr__,131,1,1,0,1,0,0,5.0,2.0,0.0,D:\BaiduNetdiskDownload\graduation_project\project_folder\ansible\module_utils\six\__init__.py,131.0
ansible.module_utils.six.__init__.MovedModule.__init__,119,1,0,1,0,0,0,8.0,3.0,0.0,D:\BaiduNetdiskDownload\graduation_project\project_folder\ansible\module_utils\six\__init__.py,119.0
ansible.module_utils.six.__init__.MovedModule._resolve,128,2,1,1,1,0,0,2.0,1.0,0.0,D:\BaiduNetdiskDownload\graduation_project\project_folder\ansible\module_utils\six\__init__.py,128.0
ansible.module_utils.six.__init__._SixMetaPathImporter.__get_module,208,3,0,3,0,0,0,5.0,2.0,0.0,D:\BaiduNetdiskDownload\graduation_project\project_folder\ansible\module_utils\six\__init__.py,208.0
ansible.module_utils.six.__init__._SixMetaPathImporter.__init__,187,1,0,1,0,0,0,3.0,2.0,0.0,D:\BaiduNetdiskDownload\graduation_project\project_folder\ansible\module_utils\six\__init__.py,187.0
ansible.module_utils.six.__init__._SixMetaPathImporter._add_module,191,1,0,1,0,0,0,3.0,3.0,0.0,D:\BaiduNetdiskDownload\graduation_project\project_folder\ansible\module_utils\six\__init__.py,191.0
ansible.module_utils.six.__init__._SixMetaPathImporter.create_module,245,1,1,0,1,0,0,2.0,2.0,0.0,D:\BaiduNetdiskDownload\graduation_project\project_folder\ansible\module_utils\six\__init__.py,245.0
ansible.module_utils.six.__init__._SixMetaPathImporter.get_code,237,1,1,0,1,0,0,6.0,2.0,0.0,D:\BaiduNetdiskDownload\graduation_project\project_folder\ansible\module_utils\six\__init__.py,237.0
ansible.module_utils.six.__init__._SixMetaPathImporter.is_package,228,1,1,0,1,0,0,8.0,2.0,0.0,D:\BaiduNetdiskDownload\graduation_project\project_folder\ansible\module_utils\six\__init__.py,228.0
ansible.module_utils.six.__init__._SixMetaPathImporter.load_module,214,2,1,1,1,0,0,13.0,2.0,0.0,D:\BaiduNetdiskDownload\graduation_project\project_folder\ansible\module_utils\six\__init__.py,214.0
ansible.module_utils.six.__init__._add_doc,89,1,0,1,0,0,0,3.0,2.0,0.0,D:\BaiduNetdiskDownload\graduation_project\project_folder\ansible\module_utils\six\__init__.py,89.0
ansible.module_utils.six.__init__._import_module,94,2,0,2,0,0,0,4.0,1.0,0.0,D:\BaiduNetdiskDownload\graduation_project\project_folder\ansible\module_utils\six\__init__.py,94.0
ansible.module_utils.six.__init__.add_metaclass,891,1,1,0,1,0,0,16.0,1.0,2.0,D:\BaiduNetdiskDownload\graduation_project\project_folder\ansible\module_utils\six\__init__.py,891.0
ansible.module_utils.six.__init__.b,654,5,0,5,0,0,0,2.0,1.0,0.0,D:\BaiduNetdiskDownload\graduation_project\project_folder\ansible\module_utils\six\__init__.py,654.0
ansible.module_utils.six.__init__.ensure_str,927,1,1,0,1,0,0,21.0,1.0,0.0,D:\BaiduNetdiskDownload\graduation_project\project_folder\ansible\module_utils\six\__init__.py,927.0
ansible.module_utils.six.__init__.ensure_text,950,1,1,0,1,0,0,17.0,1.0,0.0,D:\BaiduNetdiskDownload\graduation_project\project_folder\ansible\module_utils\six\__init__.py,950.0
ansible.module_utils.six.__init__.iteritems,615,12,1,11,1,0,0,2.0,2.0,0.0,D:\BaiduNetdiskDownload\graduation_project\project_folder\ansible\module_utils\six\__init__.py,615.0
ansible.module_utils.six.__init__.itervalues,612,1,1,0,1,0,0,2.0,2.0,0.0,D:\BaiduNetdiskDownload\graduation_project\project_folder\ansible\module_utils\six\__init__.py,612.0
ansible.module_utils.six.__init__.print_,770,2,2,0,2,0,0,6.0,2.0,2.0,D:\BaiduNetdiskDownload\graduation_project\project_folder\ansible\module_utils\six\__init__.py,770.0
ansible.module_utils.six.__init__.print_,826,1,1,0,1,0,0,6.0,2.0,2.0,D:\BaiduNetdiskDownload\graduation_project\project_folder\ansible\module_utils\six\__init__.py,770.0
ansible.module_utils.six.__init__.reraise,724,1,0,1,0,0,0,10.0,2.0,0.0,D:\BaiduNetdiskDownload\graduation_project\project_folder\ansible\module_utils\six\__init__.py,724.0
ansible.module_utils.six.__init__.wraps,857,9,0,9,0,0,0,4.0,1.0,0.0,D:\BaiduNetdiskDownload\graduation_project\project_folder\ansible\module_utils\six\__init__.py,857.0
ansible.module_utils.splitter._count_jinja2_blocks,52,1,0,1,0,0,0,13.0,4.0,0.0,D:\BaiduNetdiskDownload\graduation_project\project_folder\ansible\module_utils\splitter.py,52.0
ansible.module_utils.splitter._get_quote_state,32,1,0,1,0,0,0,18.0,2.0,0.0,D:\BaiduNetdiskDownload\graduation_project\project_folder\ansible\module_utils\splitter.py,32.0
ansible.module_utils.splitter.is_quoted,210,1,0,1,0,0,0,2.0,1.0,0.0,D:\BaiduNetdiskDownload\graduation_project\project_folder\ansible\module_utils\splitter.py,210.0
ansible.module_utils.splitter.split_args,67,7,7,0,7,0,0,141.0,1.0,0.0,D:\BaiduNetdiskDownload\graduation_project\project_folder\ansible\module_utils\splitter.py,67.0
ansible.module_utils.splitter.unquote,214,1,1,0,1,0,0,5.0,1.0,0.0,D:\BaiduNetdiskDownload\graduation_project\project_folder\ansible\module_utils\splitter.py,214.0
ansible.module_utils.urls.GzipDecodedReader.__init__,367,3,2,1,2,0,0,6.0,2.0,0.0,D:\BaiduNetdiskDownload\graduation_project\project_folder\ansible\module_utils\urls.py,367.0
ansible.module_utils.urls.GzipDecodedReader.close,374,2,1,1,1,1,1,5.0,1.0,0.0,D:\BaiduNetdiskDownload\graduation_project\project_folder\ansible\module_utils\urls.py,374.0
ansible.module_utils.urls.GzipDecodedReader.missing_gzip_error,381,3,1,2,1,0,0,6.0,1.0,0.0,D:\BaiduNetdiskDownload\graduation_project\project_folder\ansible\module_utils\urls.py,381.0
ansible.module_utils.urls.HTTPGSSAPIAuthHandler.__init__,103,1,0,1,0,0,0,4.0,1.0,0.0,D:\BaiduNetdiskDownload\graduation_project\project_folder\ansible\module_utils\urls.py,103.0
ansible.module_utils.urls.HTTPGSSAPIAuthHandler.get_auth_value,108,2,1,1,1,0,0,4.0,2.0,0.0,D:\BaiduNetdiskDownload\graduation_project\project_folder\ansible\module_utils\urls.py,108.0
ansible.module_utils.urls.HTTPGSSAPIAuthHandler.http_error_401,113,5,5,0,5,0,0,58.0,6.0,0.0,D:\BaiduNetdiskDownload\graduation_project\project_folder\ansible\module_utils\urls.py,113.0
ansible.module_utils.urls.HTTPRedirectHandler.__init__,396,1,0,1,0,0,0,2.0,1.0,0.0,D:\BaiduNetdiskDownload\graduation_project\project_folder\ansible\module_utils\urls.py,396.0
ansible.module_utils.urls.HTTPRedirectHandler.redirect_request,409,6,5,1,5,1,1,60.0,7.0,0.0,D:\BaiduNetdiskDownload\graduation_project\project_folder\ansible\module_utils\urls.py,409.0
ansible.module_utils.urls.MissingModuleError.__init__,215,2,0,2,0,0,0,4.0,3.0,0.0,D:\BaiduNetdiskDownload\graduation_project\project_folder\ansible\module_utils\urls.py,215.0
ansible.module_utils.urls.ParseResultDottedDict.__init__,307,1,0,1,0,0,0,3.0,3.0,0.0,D:\BaiduNetdiskDownload\graduation_project\project_folder\ansible\module_utils\urls.py,307.0
ansible.module_utils.urls.Request.__init__,705,1,0,1,0,0,0,48.0,1.0,0.0,D:\BaiduNetdiskDownload\graduation_project\project_folder\ansible\module_utils\urls.py,705.0
ansible.module_utils.urls.Request._fallback,754,1,0,1,0,0,0,4.0,3.0,0.0,D:\BaiduNetdiskDownload\graduation_project\project_folder\ansible\module_utils\urls.py,754.0
ansible.module_utils.urls.Request.delete,971,1,1,0,1,0,0,9.0,3.0,0.0,D:\BaiduNetdiskDownload\graduation_project\project_folder\ansible\module_utils\urls.py,971.0
ansible.module_utils.urls.Request.get,908,1,1,0,1,0,0,9.0,3.0,0.0,D:\BaiduNetdiskDownload\graduation_project\project_folder\ansible\module_utils\urls.py,908.0
ansible.module_utils.urls.Request.head,928,1,1,0,1,0,0,9.0,3.0,0.0,D:\BaiduNetdiskDownload\graduation_project\project_folder\ansible\module_utils\urls.py,928.0
ansible.module_utils.urls.Request.open,759,24,13,11,13,0,0,148.0,3.0,0.0,D:\BaiduNetdiskDownload\graduation_project\project_folder\ansible\module_utils\urls.py,759.0
ansible.module_utils.urls.Request.options,918,3,1,2,1,0,0,9.0,3.0,0.0,D:\BaiduNetdiskDownload\graduation_project\project_folder\ansible\module_utils\urls.py,918.0
ansible.module_utils.urls.Request.patch,960,1,1,0,1,0,0,10.0,3.0,0.0,D:\BaiduNetdiskDownload\graduation_project\project_folder\ansible\module_utils\urls.py,960.0
ansible.module_utils.urls.Request.post,938,1,1,0,1,0,0,10.0,3.0,0.0,D:\BaiduNetdiskDownload\graduation_project\project_folder\ansible\module_utils\urls.py,938.0
ansible.module_utils.urls.Request.put,949,10,1,9,1,0,0,10.0,3.0,0.0,D:\BaiduNetdiskDownload\graduation_project\project_folder\ansible\module_utils\urls.py,949.0
ansible.module_utils.urls.UnixHTTPConnection.__init__,275,1,0,1,0,0,0,2.0,2.0,0.0,D:\BaiduNetdiskDownload\graduation_project\project_folder\ansible\module_utils\urls.py,275.0
ansible.module_utils.urls.UnixHTTPConnection.connect,278,2,1,1,1,1,1,8.0,1.0,0.0,D:\BaiduNetdiskDownload\graduation_project\project_folder\ansible\module_utils\urls.py,278.0
ansible.module_utils.urls.UnixHTTPHandler.__init__,295,1,0,1,0,0,0,3.0,3.0,0.0,D:\BaiduNetdiskDownload\graduation_project\project_folder\ansible\module_utils\urls.py,295.0
ansible.module_utils.urls.UnixHTTPHandler.http_open,299,1,1,0,1,0,0,2.0,2.0,0.0,D:\BaiduNetdiskDownload\graduation_project\project_folder\ansible\module_utils\urls.py,299.0
ansible.module_utils.urls.UnixHTTPSConnection.__init__,236,1,0,1,0,0,0,2.0,2.0,0.0,D:\BaiduNetdiskDownload\graduation_project\project_folder\ansible\module_utils\urls.py,236.0
ansible.module_utils.urls.UnixHTTPSConnection.connect,239,1,1,0,1,0,0,8.0,1.0,0.0,D:\BaiduNetdiskDownload\graduation_project\project_folder\ansible\module_utils\urls.py,239.0
ansible.module_utils.urls.UnixHTTPSHandler.__init__,253,1,0,1,0,0,0,3.0,3.0,0.0,D:\BaiduNetdiskDownload\graduation_project\project_folder\ansible\module_utils\urls.py,253.0
ansible.module_utils.urls.UnixHTTPSHandler.https_open,257,1,1,0,1,0,0,13.0,2.0,0.0,D:\BaiduNetdiskDownload\graduation_project\project_folder\ansible\module_utils\urls.py,257.0
ansible.module_utils.urls._configure_auth,636,7,6,1,6,0,0,66.0,6.0,0.0,D:\BaiduNetdiskDownload\graduation_project\project_folder\ansible\module_utils\urls.py,636.0
ansible.module_utils.urls._split_multiext,1297,3,2,1,2,0,0,31.0,1.0,0.0,D:\BaiduNetdiskDownload\graduation_project\project_folder\ansible\module_utils\urls.py,1297.0
ansible.module_utils.urls._suffixes,1289,4,3,1,3,0,0,6.0,1.0,0.0,D:\BaiduNetdiskDownload\graduation_project\project_folder\ansible\module_utils\urls.py,1289.0
ansible.module_utils.urls.basic_auth_header,1107,2,1,1,1,0,0,7.0,2.0,0.0,D:\BaiduNetdiskDownload\graduation_project\project_folder\ansible\module_utils\urls.py,1107.0
ansible.module_utils.urls.extract_pem_certs,337,1,0,1,0,0,0,3.0,1.0,0.0,D:\BaiduNetdiskDownload\graduation_project\project_folder\ansible\module_utils\urls.py,337.0
ansible.module_utils.urls.fetch_file,1330,9,6,3,6,0,0,41.0,2.0,0.0,D:\BaiduNetdiskDownload\graduation_project\project_folder\ansible\module_utils\urls.py,1330.0
ansible.module_utils.urls.fetch_url,1136,16,10,6,10,0,0,151.0,2.0,0.0,D:\BaiduNetdiskDownload\graduation_project\project_folder\ansible\module_utils\urls.py,1136.0
ansible.module_utils.urls.generic_urlparse,318,2,1,1,1,0,0,17.0,1.0,0.0,D:\BaiduNetdiskDownload\graduation_project\project_folder\ansible\module_utils\urls.py,318.0
ansible.module_utils.urls.get_ca_certs,510,7,6,1,6,0,0,74.0,0.0,0.0,D:\BaiduNetdiskDownload\graduation_project\project_folder\ansible\module_utils\urls.py,510.0
ansible.module_utils.urls.get_channel_binding_cert_hash,596,1,0,1,0,0,0,21.0,1.0,0.0,D:\BaiduNetdiskDownload\graduation_project\project_folder\ansible\module_utils\urls.py,596.0
ansible.module_utils.urls.get_response_filename,342,2,1,1,1,0,0,8.0,1.0,0.0,D:\BaiduNetdiskDownload\graduation_project\project_folder\ansible\module_utils\urls.py,342.0
ansible.module_utils.urls.get_user_agent,1373,2,0,2,0,0,0,3.0,1.0,0.0,D:\BaiduNetdiskDownload\graduation_project\project_folder\ansible\module_utils\urls.py,1373.0
ansible.module_utils.urls.getpeercert,586,1,0,1,0,0,0,8.0,1.0,0.0,D:\BaiduNetdiskDownload\graduation_project\project_folder\ansible\module_utils\urls.py,586.0
ansible.module_utils.urls.make_context,471,5,4,1,4,0,0,37.0,0.0,0.0,D:\BaiduNetdiskDownload\graduation_project\project_folder\ansible\module_utils\urls.py,471.0
ansible.module_utils.urls.open_url,982,11,2,9,2,0,0,20.0,1.0,0.0,D:\BaiduNetdiskDownload\graduation_project\project_folder\ansible\module_utils\urls.py,982.0
ansible.module_utils.urls.parse_content_type,352,2,1,1,1,0,0,7.0,1.0,0.0,D:\BaiduNetdiskDownload\graduation_project\project_folder\ansible\module_utils\urls.py,352.0
ansible.module_utils.urls.prepare_multipart,1004,6,4,2,4,0,0,96.0,1.0,0.0,D:\BaiduNetdiskDownload\graduation_project\project_folder\ansible\module_utils\urls.py,1004.0
ansible.module_utils.urls.rfc2822_date_string,619,1,0,1,0,0,0,15.0,1.0,0.0,D:\BaiduNetdiskDownload\graduation_project\project_folder\ansible\module_utils\urls.py,619.0
ansible.module_utils.urls.unix_socket_patch_httpconnection_connect,225,1,0,1,0,0,0,9.0,1.0,0.0,D:\BaiduNetdiskDownload\graduation_project\project_folder\ansible\module_utils\urls.py,225.0
ansible.module_utils.urls.url_argument_spec,1116,2,0,2,0,0,0,18.0,1.0,0.0,D:\BaiduNetdiskDownload\graduation_project\project_folder\ansible\module_utils\urls.py,1116.0
ansible.module_utils.yumdnf.YumDnf.__init__,67,3,3,0,3,0,0,65.0,2.0,0.0,D:\BaiduNetdiskDownload\graduation_project\project_folder\ansible\module_utils\yumdnf.py,67.0
ansible.module_utils.yumdnf.YumDnf.listify_comma_sep_strings_in_list,133,5,4,1,4,0,0,22.0,2.0,0.0,D:\BaiduNetdiskDownload\graduation_project\project_folder\ansible\module_utils\yumdnf.py,133.0
ansible.modules.apt.PolicyRcD.__enter__,432,2,2,0,2,0,0,24.0,1.0,0.0,D:\BaiduNetdiskDownload\graduation_project\project_folder\ansible\modules\apt.py,432.0
ansible.modules.apt.PolicyRcD.__exit__,457,1,1,0,1,0,0,26.0,4.0,0.0,D:\BaiduNetdiskDownload\graduation_project\project_folder\ansible\modules\apt.py,457.0
ansible.modules.apt.PolicyRcD.__init__,416,5,0,5,0,0,0,15.0,2.0,0.0,D:\BaiduNetdiskDownload\graduation_project\project_folder\ansible\modules\apt.py,416.0
ansible.modules.apt.aptclean,1048,4,3,1,3,0,0,9.0,1.0,0.0,D:\BaiduNetdiskDownload\graduation_project\project_folder\ansible\modules\apt.py,1048.0
ansible.modules.apt.cleanup,1010,6,5,1,5,0,0,36.0,1.0,0.0,D:\BaiduNetdiskDownload\graduation_project\project_folder\ansible\modules\apt.py,1010.0
ansible.modules.apt.expand_dpkg_options,610,4,2,2,2,0,0,7.0,1.0,0.0,D:\BaiduNetdiskDownload\graduation_project\project_folder\ansible\modules\apt.py,610.0
ansible.modules.apt.expand_pkgspec_from_fnmatches,619,7,5,2,5,0,0,45.0,3.0,0.0,D:\BaiduNetdiskDownload\graduation_project\project_folder\ansible\modules\apt.py,619.0
ansible.modules.apt.get_cache,1186,4,3,1,3,0,0,11.0,1.0,0.0,D:\BaiduNetdiskDownload\graduation_project\project_folder\ansible\modules\apt.py,1160.0
ansible.modules.apt.get_cache_mtime,1160,1,0,1,0,0,0,11.0,1.0,0.0,D:\BaiduNetdiskDownload\graduation_project\project_folder\ansible\modules\apt.py,1160.0
ansible.modules.apt.get_field_of_deb,838,4,3,1,3,0,0,7.0,2.0,0.0,D:\BaiduNetdiskDownload\graduation_project\project_folder\ansible\modules\apt.py,838.0
ansible.modules.apt.get_updated_cache_time,1173,2,1,1,1,0,0,10.0,1.0,0.0,D:\BaiduNetdiskDownload\graduation_project\project_folder\ansible\modules\apt.py,1173.0
ansible.modules.apt.install,710,11,9,2,9,0,0,126.0,3.0,0.0,D:\BaiduNetdiskDownload\graduation_project\project_folder\ansible\modules\apt.py,710.0
ansible.modules.apt.install_deb,847,15,14,1,14,0,0,98.0,10.0,0.0,D:\BaiduNetdiskDownload\graduation_project\project_folder\ansible\modules\apt.py,847.0
ansible.modules.apt.main,1209,25,24,1,24,0,0,334.0,1.0,0.0,D:\BaiduNetdiskDownload\graduation_project\project_folder\ansible\modules\apt.py,1209.0
ansible.modules.apt.mark_installed_manually,688,4,3,1,3,0,0,20.0,2.0,0.0,D:\BaiduNetdiskDownload\graduation_project\project_folder\ansible\modules\apt.py,688.0
ansible.modules.apt.package_best_match,499,1,0,1,0,0,0,22.0,5.0,0.0,D:\BaiduNetdiskDownload\graduation_project\project_folder\ansible\modules\apt.py,499.0
ansible.modules.apt.package_split,485,3,0,3,0,0,0,5.0,1.0,0.0,D:\BaiduNetdiskDownload\graduation_project\project_folder\ansible\modules\apt.py,485.0
ansible.modules.apt.package_status,523,6,3,3,3,1,1,85.0,7.0,0.0,D:\BaiduNetdiskDownload\graduation_project\project_folder\ansible\modules\apt.py,523.0
ansible.modules.apt.package_version_compare,492,1,0,1,0,0,0,5.0,2.0,0.0,D:\BaiduNetdiskDownload\graduation_project\project_folder\ansible\modules\apt.py,492.0
ansible.modules.apt.parse_diff,666,9,3,6,3,0,0,20.0,1.0,0.0,D:\BaiduNetdiskDownload\graduation_project\project_folder\ansible\modules\apt.py,666.0
ansible.modules.apt.remove,947,11,10,1,10,0,0,61.0,3.0,0.0,D:\BaiduNetdiskDownload\graduation_project\project_folder\ansible\modules\apt.py,947.0
ansible.modules.apt.upgrade,1059,9,5,4,5,0,0,99.0,1.0,0.0,D:\BaiduNetdiskDownload\graduation_project\project_folder\ansible\modules\apt.py,1059.0
ansible.modules.apt_key.add_http_proxy,203,1,0,1,0,0,0,11.0,1.0,0.0,D:\BaiduNetdiskDownload\graduation_project\project_folder\ansible\modules\apt_key.py,203.0
ansible.modules.apt_key.add_key,369,3,2,1,2,0,0,31.0,3.0,0.0,D:\BaiduNetdiskDownload\graduation_project\project_folder\ansible\modules\apt_key.py,369.0
ansible.modules.apt_key.all_keys,280,4,3,1,3,0,0,10.0,3.0,0.0,D:\BaiduNetdiskDownload\graduation_project\project_folder\ansible\modules\apt_key.py,280.0
ansible.modules.apt_key.download_key,303,4,3,1,3,0,0,11.0,2.0,0.0,D:\BaiduNetdiskDownload\graduation_project\project_folder\ansible\modules\apt_key.py,303.0
ansible.modules.apt_key.find_needed_binaries,196,1,0,1,0,0,0,5.0,1.0,0.0,D:\BaiduNetdiskDownload\graduation_project\project_folder\ansible\modules\apt_key.py,196.0
ansible.modules.apt_key.get_key_id_from_data,337,2,1,1,1,0,0,2.0,2.0,0.0,D:\BaiduNetdiskDownload\graduation_project\project_folder\ansible\modules\apt_key.py,337.0
ansible.modules.apt_key.get_key_id_from_file,316,7,5,2,5,0,0,19.0,2.0,0.0,D:\BaiduNetdiskDownload\graduation_project\project_folder\ansible\modules\apt_key.py,316.0
ansible.modules.apt_key.import_key,341,5,4,1,4,0,0,26.0,4.0,0.0,D:\BaiduNetdiskDownload\graduation_project\project_folder\ansible\modules\apt_key.py,341.0
ansible.modules.apt_key.lang_env,187,3,1,2,1,0,0,7.0,1.0,0.0,D:\BaiduNetdiskDownload\graduation_project\project_folder\ansible\modules\apt_key.py,187.0
ansible.modules.apt_key.main,420,13,12,1,12,0,0,109.0,1.0,0.0,D:\BaiduNetdiskDownload\graduation_project\project_folder\ansible\modules\apt_key.py,420.0
ansible.modules.apt_key.parse_key_id,216,3,2,1,2,0,0,35.0,1.0,0.0,D:\BaiduNetdiskDownload\graduation_project\project_folder\ansible\modules\apt_key.py,216.0
ansible.modules.apt_key.parse_output_for_keys,253,6,4,2,4,0,0,25.0,1.0,0.0,D:\BaiduNetdiskDownload\graduation_project\project_folder\ansible\modules\apt_key.py,253.0
ansible.modules.apt_key.remove_key,402,3,2,1,2,0,0,16.0,3.0,0.0,D:\BaiduNetdiskDownload\graduation_project\project_folder\ansible\modules\apt_key.py,402.0
ansible.modules.apt_key.shorten_key_ids,292,2,1,1,1,0,0,9.0,1.0,0.0,D:\BaiduNetdiskDownload\graduation_project\project_folder\ansible\modules\apt_key.py,292.0
ansible.modules.apt_repository.SourcesList.__init__,229,3,3,0,3,0,0,17.0,2.0,0.0,D:\BaiduNetdiskDownload\graduation_project\project_folder\ansible\modules\apt_repository.py,229.0
ansible.modules.apt_repository.SourcesList.__iter__,247,1,1,0,1,0,0,6.0,1.0,0.0,D:\BaiduNetdiskDownload\graduation_project\project_folder\ansible\modules\apt_repository.py,247.0
ansible.modules.apt_repository.SourcesList._add_valid_source,423,7,5,2,5,0,0,22.0,4.0,0.0,D:\BaiduNetdiskDownload\graduation_project\project_folder\ansible\modules\apt_repository.py,423.0
ansible.modules.apt_repository.SourcesList._apt_cfg_dir,328,2,0,2,0,0,0,9.0,1.0,0.0,D:\BaiduNetdiskDownload\graduation_project\project_folder\ansible\modules\apt_repository.py,328.0
ansible.modules.apt_repository.SourcesList._apt_cfg_file,317,1,0,1,0,0,0,9.0,1.0,0.0,D:\BaiduNetdiskDownload\graduation_project\project_folder\ansible\modules\apt_repository.py,317.0
ansible.modules.apt_repository.SourcesList._choice,410,1,0,1,0,0,0,4.0,3.0,0.0,D:\BaiduNetdiskDownload\graduation_project\project_folder\ansible\modules\apt_repository.py,410.0
ansible.modules.apt_repository.SourcesList._expand_path,254,2,1,1,1,0,0,5.0,2.0,0.0,D:\BaiduNetdiskDownload\graduation_project\project_folder\ansible\modules\apt_repository.py,254.0
ansible.modules.apt_repository.SourcesList._parse,285,10,5,5,5,0,0,30.0,2.0,0.0,D:\BaiduNetdiskDownload\graduation_project\project_folder\ansible\modules\apt_repository.py,285.0
ansible.modules.apt_repository.SourcesList._remove_valid_source,452,3,1,2,1,0,0,5.0,2.0,0.0,D:\BaiduNetdiskDownload\graduation_project\project_folder\ansible\modules\apt_repository.py,452.0
ansible.modules.apt_repository.SourcesList._suggest_filename,260,4,2,2,2,0,0,24.0,2.0,2.0,D:\BaiduNetdiskDownload\graduation_project\project_folder\ansible\modules\apt_repository.py,260.0
ansible.modules.apt_repository.SourcesList.add_source,446,3,3,0,3,0,0,5.0,2.0,0.0,D:\BaiduNetdiskDownload\graduation_project\project_folder\ansible\modules\apt_repository.py,446.0
ansible.modules.apt_repository.SourcesList.dump,392,4,3,1,3,0,0,17.0,1.0,0.0,D:\BaiduNetdiskDownload\graduation_project\project_folder\ansible\modules\apt_repository.py,392.0
ansible.modules.apt_repository.SourcesList.load,338,3,2,1,2,0,0,7.0,2.0,0.0,D:\BaiduNetdiskDownload\graduation_project\project_folder\ansible\modules\apt_repository.py,338.0
ansible.modules.apt_repository.SourcesList.modify,415,2,1,1,1,0,0,7.0,3.0,0.0,D:\BaiduNetdiskDownload\graduation_project\project_folder\ansible\modules\apt_repository.py,415.0
ansible.modules.apt_repository.SourcesList.remove_source,458,2,2,0,2,0,0,3.0,2.0,0.0,D:\BaiduNetdiskDownload\graduation_project\project_folder\ansible\modules\apt_repository.py,458.0
ansible.modules.apt_repository.SourcesList.save,346,8,7,1,7,0,0,45.0,1.0,0.0,D:\BaiduNetdiskDownload\graduation_project\project_folder\ansible\modules\apt_repository.py,346.0
ansible.modules.apt_repository.UbuntuSourcesList.__deepcopy__,480,1,1,0,1,0,0,2.0,1.0,0.0,D:\BaiduNetdiskDownload\graduation_project\project_folder\ansible\modules\apt_repository.py,480.0
ansible.modules.apt_repository.UbuntuSourcesList.__init__,470,3,1,2,1,0,0,9.0,2.0,0.0,D:\BaiduNetdiskDownload\graduation_project\project_folder\ansible\modules\apt_repository.py,470.0
ansible.modules.apt_repository.UbuntuSourcesList._expand_ppa,492,4,1,3,1,0,0,10.0,2.0,0.0,D:\BaiduNetdiskDownload\graduation_project\project_folder\ansible\modules\apt_repository.py,492.0
ansible.modules.apt_repository.UbuntuSourcesList._get_ppa_info,483,4,3,1,3,0,0,8.0,3.0,0.0,D:\BaiduNetdiskDownload\graduation_project\project_folder\ansible\modules\apt_repository.py,483.0
ansible.modules.apt_repository.UbuntuSourcesList._gpg_key_exists,516,4,3,1,3,0,0,22.0,2.0,0.0,D:\BaiduNetdiskDownload\graduation_project\project_folder\ansible\modules\apt_repository.py,516.0
ansible.modules.apt_repository.UbuntuSourcesList._key_already_exists,503,4,3,1,3,0,0,12.0,2.0,0.0,D:\BaiduNetdiskDownload\graduation_project\project_folder\ansible\modules\apt_repository.py,503.0
ansible.modules.apt_repository.UbuntuSourcesList.add_source,540,14,13,1,13,0,0,49.0,2.0,0.0,D:\BaiduNetdiskDownload\graduation_project\project_folder\ansible\modules\apt_repository.py,540.0
ansible.modules.apt_repository.UbuntuSourcesList.remove_source,590,5,4,1,4,0,0,6.0,2.0,0.0,D:\BaiduNetdiskDownload\graduation_project\project_folder\ansible\modules\apt_repository.py,590.0
ansible.modules.apt_repository.UbuntuSourcesList.repos_urls,598,4,4,0,4,0,0,18.0,1.0,0.0,D:\BaiduNetdiskDownload\graduation_project\project_folder\ansible\modules\apt_repository.py,598.0
ansible.modules.apt_repository.install_python_apt,207,4,3,1,3,0,0,13.0,2.0,0.0,D:\BaiduNetdiskDownload\graduation_project\project_folder\ansible\modules\apt_repository.py,207.0
ansible.modules.apt_repository.main,629,16,15,1,15,0,0,141.0,1.0,0.0,D:\BaiduNetdiskDownload\graduation_project\project_folder\ansible\modules\apt_repository.py,629.0
ansible.modules.apt_repository.revert_sources_list,618,1,0,1,0,0,0,9.0,3.0,0.0,D:\BaiduNetdiskDownload\graduation_project\project_folder\ansible\modules\apt_repository.py,618.0
ansible.modules.assemble.assemble_from_fragments,138,7,6,1,6,0,0,44.0,1.0,0.0,D:\BaiduNetdiskDownload\graduation_project\project_folder\ansible\modules\assemble.py,138.0
ansible.modules.assemble.cleanup,184,1,0,1,0,0,0,9.0,1.0,0.0,D:\BaiduNetdiskDownload\graduation_project\project_folder\ansible\modules\assemble.py,184.0
ansible.modules.assemble.main,195,13,12,1,12,0,0,86.0,1.0,0.0,D:\BaiduNetdiskDownload\graduation_project\project_folder\ansible\modules\assemble.py,195.0
ansible.modules.async_status.main,118,6,5,1,5,0,0,52.0,1.0,0.0,D:\BaiduNetdiskDownload\graduation_project\project_folder\ansible\modules\async_status.py,118.0
ansible.modules.async_wrapper._filter_non_json_lines,77,7,6,1,6,0,0,38.0,1.0,0.0,D:\BaiduNetdiskDownload\graduation_project\project_folder\ansible\modules\async_wrapper.py,77.0
ansible.modules.async_wrapper._get_interpreter,117,5,4,1,4,0,0,6.0,1.0,0.0,D:\BaiduNetdiskDownload\graduation_project\project_folder\ansible\modules\async_wrapper.py,117.0
ansible.modules.async_wrapper._make_temp_dir,125,1,0,1,0,0,0,7.0,1.0,0.0,D:\BaiduNetdiskDownload\graduation_project\project_folder\ansible\modules\async_wrapper.py,125.0
ansible.modules.async_wrapper._run_module,148,9,8,1,8,0,0,72.0,2.0,0.0,D:\BaiduNetdiskDownload\graduation_project\project_folder\ansible\modules\async_wrapper.py,148.0
ansible.modules.async_wrapper.daemonize_self,44,2,1,1,1,0,0,29.0,1.0,0.0,D:\BaiduNetdiskDownload\graduation_project\project_folder\ansible\modules\async_wrapper.py,44.0
ansible.modules.async_wrapper.end,37,4,0,4,0,0,0,5.0,0.0,0.0,D:\BaiduNetdiskDownload\graduation_project\project_folder\ansible\modules\async_wrapper.py,37.0
ansible.modules.async_wrapper.jwrite,134,4,2,2,2,0,0,12.0,1.0,0.0,D:\BaiduNetdiskDownload\graduation_project\project_folder\ansible\modules\async_wrapper.py,134.0
ansible.modules.async_wrapper.main,222,8,7,1,7,0,0,127.0,1.0,0.0,D:\BaiduNetdiskDownload\graduation_project\project_folder\ansible\modules\async_wrapper.py,222.0
ansible.modules.async_wrapper.notice,33,2,0,2,0,0,0,2.0,1.0,0.0,D:\BaiduNetdiskDownload\graduation_project\project_folder\ansible\modules\async_wrapper.py,33.0
ansible.modules.blockinfile.check_file_attrs,224,3,2,1,2,0,0,11.0,4.0,0.0,D:\BaiduNetdiskDownload\graduation_project\project_folder\ansible\modules\blockinfile.py,224.0
ansible.modules.blockinfile.main,237,16,15,1,15,0,0,189.0,1.0,0.0,D:\BaiduNetdiskDownload\graduation_project\project_folder\ansible\modules\blockinfile.py,237.0
ansible.modules.blockinfile.write_changes,203,5,4,1,4,0,0,19.0,3.0,0.0,D:\BaiduNetdiskDownload\graduation_project\project_folder\ansible\modules\blockinfile.py,203.0
ansible.modules.command.main,244,12,11,1,11,0,0,128.0,1.0,0.0,D:\BaiduNetdiskDownload\graduation_project\project_folder\ansible\modules\command.py,244.0
ansible.modules.copy.AnsibleModuleError.__init__,304,1,0,1,0,0,0,2.0,2.0,0.0,D:\BaiduNetdiskDownload\graduation_project\project_folder\ansible\modules\copy.py,304.0
ansible.modules.copy.adjust_recursive_directory_permissions,326,5,3,2,3,1,1,11.0,5.0,0.0,D:\BaiduNetdiskDownload\graduation_project\project_folder\ansible\modules\copy.py,326.0
ansible.modules.copy.chown_recursive,339,4,2,2,2,0,0,63.0,2.0,0.0,D:\BaiduNetdiskDownload\graduation_project\project_folder\ansible\modules\copy.py,339.0
ansible.modules.copy.copy_common_dirs,488,6,4,2,4,1,1,16.0,3.0,0.0,D:\BaiduNetdiskDownload\graduation_project\project_folder\ansible\modules\copy.py,488.0
ansible.modules.copy.copy_diff_files,404,5,3,2,3,0,0,29.0,3.0,0.0,D:\BaiduNetdiskDownload\graduation_project\project_folder\ansible\modules\copy.py,404.0
ansible.modules.copy.copy_left_only,435,6,4,2,4,0,0,51.0,3.0,0.0,D:\BaiduNetdiskDownload\graduation_project\project_folder\ansible\modules\copy.py,435.0
ansible.modules.copy.main,506,25,24,1,24,0,0,248.0,1.0,0.0,D:\BaiduNetdiskDownload\graduation_project\project_folder\ansible\modules\copy.py,506.0
ansible.modules.copy.split_pre_existing_dir,308,6,4,2,4,1,1,16.0,1.0,0.0,D:\BaiduNetdiskDownload\graduation_project\project_folder\ansible\modules\copy.py,308.0
ansible.modules.cron.CronTab.__init__,234,3,2,1,2,0,0,21.0,2.0,0.0,D:\BaiduNetdiskDownload\graduation_project\project_folder\ansible\modules\cron.py,234.0
ansible.modules.cron.CronTab._read_user_execute,517,1,0,1,0,0,0,15.0,1.0,0.0,D:\BaiduNetdiskDownload\graduation_project\project_folder\ansible\modules\cron.py,517.0
ansible.modules.cron.CronTab._update_env,493,3,1,2,1,0,0,10.0,4.0,0.0,D:\BaiduNetdiskDownload\graduation_project\project_folder\ansible\modules\cron.py,493.0
ansible.modules.cron.CronTab._update_job,472,4,2,2,2,0,0,20.0,4.0,0.0,D:\BaiduNetdiskDownload\graduation_project\project_folder\ansible\modules\cron.py,472.0
ansible.modules.cron.CronTab._write_execute,533,1,0,1,0,0,0,12.0,2.0,0.0,D:\BaiduNetdiskDownload\graduation_project\project_folder\ansible\modules\cron.py,533.0
ansible.modules.cron.CronTab.add_env,358,3,2,1,2,0,0,19.0,2.0,0.0,D:\BaiduNetdiskDownload\graduation_project\project_folder\ansible\modules\cron.py,358.0
ansible.modules.cron.CronTab.add_job,337,3,2,1,2,0,0,6.0,3.0,0.0,D:\BaiduNetdiskDownload\graduation_project\project_folder\ansible\modules\cron.py,337.0
ansible.modules.cron.CronTab.do_add_env,381,1,1,0,1,0,0,2.0,3.0,0.0,D:\BaiduNetdiskDownload\graduation_project\project_folder\ansible\modules\cron.py,381.0
ansible.modules.cron.CronTab.do_add_job,347,1,1,0,1,0,0,4.0,4.0,0.0,D:\BaiduNetdiskDownload\graduation_project\project_folder\ansible\modules\cron.py,347.0
ansible.modules.cron.CronTab.do_comment,334,3,0,3,0,0,0,2.0,2.0,0.0,D:\BaiduNetdiskDownload\graduation_project\project_folder\ansible\modules\cron.py,334.0
ansible.modules.cron.CronTab.find_env,427,2,0,2,0,0,0,6.0,2.0,0.0,D:\BaiduNetdiskDownload\graduation_project\project_folder\ansible\modules\cron.py,427.0
ansible.modules.cron.CronTab.find_job,400,2,1,1,1,0,0,26.0,2.0,0.0,D:\BaiduNetdiskDownload\graduation_project\project_folder\ansible\modules\cron.py,400.0
ansible.modules.cron.CronTab.get_cron_job,434,2,1,1,1,0,0,19.0,9.0,0.0,D:\BaiduNetdiskDownload\graduation_project\project_folder\ansible\modules\cron.py,434.0
ansible.modules.cron.CronTab.get_envnames,463,3,2,1,2,0,0,8.0,1.0,0.0,D:\BaiduNetdiskDownload\graduation_project\project_folder\ansible\modules\cron.py,463.0
ansible.modules.cron.CronTab.get_jobnames,454,2,1,1,1,0,0,8.0,1.0,0.0,D:\BaiduNetdiskDownload\graduation_project\project_folder\ansible\modules\cron.py,454.0
ansible.modules.cron.CronTab.is_empty,292,2,1,1,1,0,0,8.0,1.0,0.0,D:\BaiduNetdiskDownload\graduation_project\project_folder\ansible\modules\cron.py,292.0
ansible.modules.cron.CronTab.read,256,90,5,85,5,1,2,35.0,1.0,0.0,D:\BaiduNetdiskDownload\graduation_project\project_folder\ansible\modules\cron.py,256.0
ansible.modules.cron.CronTab.remove_env,384,2,1,1,1,0,0,2.0,2.0,0.0,D:\BaiduNetdiskDownload\graduation_project\project_folder\ansible\modules\cron.py,384.0
ansible.modules.cron.CronTab.remove_job,352,2,1,1,1,0,0,2.0,2.0,0.0,D:\BaiduNetdiskDownload\graduation_project\project_folder\ansible\modules\cron.py,352.0
ansible.modules.cron.CronTab.remove_job_file,390,1,0,1,0,0,0,9.0,1.0,0.0,D:\BaiduNetdiskDownload\graduation_project\project_folder\ansible\modules\cron.py,390.0
ansible.modules.cron.CronTab.render,504,6,3,3,3,0,0,12.0,1.0,0.0,D:\BaiduNetdiskDownload\graduation_project\project_folder\ansible\modules\cron.py,504.0
ansible.modules.cron.CronTab.update_env,378,2,1,1,1,0,0,2.0,3.0,0.0,D:\BaiduNetdiskDownload\graduation_project\project_folder\ansible\modules\cron.py,378.0
ansible.modules.cron.CronTab.update_job,344,2,1,1,1,0,0,2.0,3.0,0.0,D:\BaiduNetdiskDownload\graduation_project\project_folder\ansible\modules\cron.py,344.0
ansible.modules.cron.CronTab.write,301,70,8,62,8,1,2,32.0,1.0,0.0,D:\BaiduNetdiskDownload\graduation_project\project_folder\ansible\modules\cron.py,301.0
ansible.modules.cron.main,547,24,23,1,23,0,0,215.0,1.0,0.0,D:\BaiduNetdiskDownload\graduation_project\project_folder\ansible\modules\cron.py,547.0
ansible.modules.deb822_repository.ensure_keyrings_dir,259,2,1,1,1,0,0,20.0,1.0,0.0,D:\BaiduNetdiskDownload\graduation_project\project_folder\ansible\modules\deb822_repository.py,259.0
ansible.modules.deb822_repository.format_bool,292,1,0,1,0,0,0,2.0,1.0,0.0,D:\BaiduNetdiskDownload\graduation_project\project_folder\ansible\modules\deb822_repository.py,292.0
ansible.modules.deb822_repository.format_field_name,307,3,2,1,2,0,0,6.0,1.0,0.0,D:\BaiduNetdiskDownload\graduation_project\project_folder\ansible\modules\deb822_repository.py,307.0
ansible.modules.deb822_repository.format_list,296,2,1,1,1,0,0,2.0,1.0,0.0,D:\BaiduNetdiskDownload\graduation_project\project_folder\ansible\modules\deb822_repository.py,296.0
ansible.modules.deb822_repository.format_multiline,300,4,3,1,3,0,0,5.0,1.0,0.0,D:\BaiduNetdiskDownload\graduation_project\project_folder\ansible\modules\deb822_repository.py,300.0
ansible.modules.deb822_repository.is_armored,315,1,0,1,0,0,0,2.0,1.0,0.0,D:\BaiduNetdiskDownload\graduation_project\project_folder\ansible\modules\deb822_repository.py,315.0
ansible.modules.deb822_repository.main,362,21,20,1,20,0,0,190.0,1.0,0.0,D:\BaiduNetdiskDownload\graduation_project\project_folder\ansible\modules\deb822_repository.py,362.0
ansible.modules.deb822_repository.make_signed_by_filename,281,2,0,2,0,0,0,2.0,2.0,0.0,D:\BaiduNetdiskDownload\graduation_project\project_folder\ansible\modules\deb822_repository.py,281.0
ansible.modules.deb822_repository.make_sources_filename,285,1,0,1,0,0,0,5.0,1.0,0.0,D:\BaiduNetdiskDownload\graduation_project\project_folder\ansible\modules\deb822_repository.py,285.0
ansible.modules.deb822_repository.write_signed_by_key,319,12,11,1,11,0,0,41.0,3.0,0.0,D:\BaiduNetdiskDownload\graduation_project\project_folder\ansible\modules\deb822_repository.py,319.0
ansible.modules.debconf.get_password_value,132,5,4,1,4,0,0,20.0,4.0,0.0,D:\BaiduNetdiskDownload\graduation_project\project_folder\ansible\modules\debconf.py,132.0
ansible.modules.debconf.get_selections,154,7,6,1,6,0,0,14.0,2.0,0.0,D:\BaiduNetdiskDownload\graduation_project\project_folder\ansible\modules\debconf.py,154.0
ansible.modules.debconf.main,183,12,11,1,11,0,0,77.0,1.0,0.0,D:\BaiduNetdiskDownload\graduation_project\project_folder\ansible\modules\debconf.py,183.0
ansible.modules.debconf.set_selection,170,5,4,1,4,0,0,11.0,6.0,0.0,D:\BaiduNetdiskDownload\graduation_project\project_folder\ansible\modules\debconf.py,170.0
ansible.modules.dnf5.Dnf5Module.__init__,431,2,1,1,1,0,0,5.0,2.0,0.0,D:\BaiduNetdiskDownload\graduation_project\project_folder\ansible\modules\dnf5.py,431.0
ansible.modules.dnf5.Dnf5Module._ensure_dnf,437,7,6,1,6,0,0,39.0,1.0,0.0,D:\BaiduNetdiskDownload\graduation_project\project_folder\ansible\modules\dnf5.py,437.0
ansible.modules.dnf5.Dnf5Module.run,477,10,10,0,10,0,0,239.0,1.0,0.0,D:\BaiduNetdiskDownload\graduation_project\project_folder\ansible\modules\dnf5.py,477.0
ansible.modules.dnf5.get_unneeded_pkgs,423,1,0,1,0,0,0,5.0,1.0,0.0,D:\BaiduNetdiskDownload\graduation_project\project_folder\ansible\modules\dnf5.py,423.0
ansible.modules.dnf5.is_installed,357,1,0,1,0,0,0,6.0,2.0,0.0,D:\BaiduNetdiskDownload\graduation_project\project_folder\ansible\modules\dnf5.py,357.0
ansible.modules.dnf5.is_newer_version_installed,365,4,3,1,3,0,0,42.0,2.0,0.0,D:\BaiduNetdiskDownload\graduation_project\project_folder\ansible\modules\dnf5.py,365.0
ansible.modules.dnf5.main,718,3,2,1,2,0,0,2.0,1.0,0.0,D:\BaiduNetdiskDownload\graduation_project\project_folder\ansible\modules\dnf5.py,718.0
ansible.modules.dnf5.package_to_dict,409,2,1,1,1,0,0,12.0,1.0,0.0,D:\BaiduNetdiskDownload\graduation_project\project_folder\ansible\modules\dnf5.py,409.0
ansible.modules.dnf.DnfModule.__init__,413,2,1,1,1,0,0,11.0,2.0,0.0,D:\BaiduNetdiskDownload\graduation_project\project_folder\ansible\modules\dnf.py,413.0
ansible.modules.dnf.DnfModule._base,644,7,6,1,6,0,0,60.0,7.0,0.0,D:\BaiduNetdiskDownload\graduation_project\project_folder\ansible\modules\dnf.py,644.0
ansible.modules.dnf.DnfModule._configure_base,522,5,4,1,4,0,0,99.0,4.0,0.0,D:\BaiduNetdiskDownload\graduation_project\project_folder\ansible\modules\dnf.py,522.0
ansible.modules.dnf.DnfModule._ensure_dnf,480,7,6,1,6,0,0,41.0,1.0,0.0,D:\BaiduNetdiskDownload\graduation_project\project_folder\ansible\modules\dnf.py,480.0
ansible.modules.dnf.DnfModule._install_remote_rpms,875,8,7,1,7,0,0,31.0,2.0,0.0,D:\BaiduNetdiskDownload\graduation_project\project_folder\ansible\modules\dnf.py,875.0
ansible.modules.dnf.DnfModule._is_installed,728,2,0,2,0,0,0,4.0,2.0,0.0,D:\BaiduNetdiskDownload\graduation_project\project_folder\ansible\modules\dnf.py,728.0
ansible.modules.dnf.DnfModule._is_module_installed,907,2,1,1,1,0,0,16.0,2.0,0.0,D:\BaiduNetdiskDownload\graduation_project\project_folder\ansible\modules\dnf.py,907.0
ansible.modules.dnf.DnfModule._is_newer_version_installed,733,2,0,2,0,0,0,12.0,2.0,0.0,D:\BaiduNetdiskDownload\graduation_project\project_folder\ansible\modules\dnf.py,733.0
ansible.modules.dnf.DnfModule._mark_package_install,746,7,6,1,6,0,0,69.0,2.0,0.0,D:\BaiduNetdiskDownload\graduation_project\project_folder\ansible\modules\dnf.py,746.0
ansible.modules.dnf.DnfModule._package_dict,454,3,1,2,1,0,0,25.0,2.0,0.0,D:\BaiduNetdiskDownload\graduation_project\project_folder\ansible\modules\dnf.py,454.0
ansible.modules.dnf.DnfModule._parse_spec_group_file,816,6,5,1,5,0,0,36.0,1.0,0.0,D:\BaiduNetdiskDownload\graduation_project\project_folder\ansible\modules\dnf.py,816.0
ansible.modules.dnf.DnfModule._sanitize_dnf_error_msg_install,425,3,2,1,2,0,0,12.0,3.0,0.0,D:\BaiduNetdiskDownload\graduation_project\project_folder\ansible\modules\dnf.py,425.0
ansible.modules.dnf.DnfModule._sanitize_dnf_error_msg_remove,438,2,1,1,1,0,0,15.0,3.0,0.0,D:\BaiduNetdiskDownload\graduation_project\project_folder\ansible\modules\dnf.py,438.0
ansible.modules.dnf.DnfModule._specify_repositories,622,1,0,1,0,0,0,21.0,4.0,0.0,D:\BaiduNetdiskDownload\graduation_project\project_folder\ansible\modules\dnf.py,622.0
ansible.modules.dnf.DnfModule._update_only,853,8,6,2,6,0,0,21.0,2.0,0.0,D:\BaiduNetdiskDownload\graduation_project\project_folder\ansible\modules\dnf.py,853.0
ansible.modules.dnf.DnfModule.ensure,924,17,16,1,16,0,0,341.0,1.0,0.0,D:\BaiduNetdiskDownload\graduation_project\project_folder\ansible\modules\dnf.py,924.0
ansible.modules.dnf.DnfModule.list_items,705,3,2,1,2,0,0,22.0,2.0,0.0,D:\BaiduNetdiskDownload\graduation_project\project_folder\ansible\modules\dnf.py,705.0
ansible.modules.dnf.DnfModule.run,1266,7,6,1,6,0,0,62.0,1.0,0.0,D:\BaiduNetdiskDownload\graduation_project\project_folder\ansible\modules\dnf.py,1266.0
ansible.modules.dnf.main,1330,6,5,1,5,0,0,28.0,1.0,0.0,D:\BaiduNetdiskDownload\graduation_project\project_folder\ansible\modules\dnf.py,1330.0
ansible.modules.dpkg_selections.main,59,8,7,1,7,0,0,34.0,1.0,0.0,D:\BaiduNetdiskDownload\graduation_project\project_folder\ansible\modules\dpkg_selections.py,59.0
ansible.modules.expect.main,153,11,10,1,10,0,0,120.0,1.0,0.0,D:\BaiduNetdiskDownload\graduation_project\project_folder\ansible\modules\expect.py,153.0
ansible.modules.expect.response_closure,138,4,3,1,3,0,0,13.0,3.0,2.0,D:\BaiduNetdiskDownload\graduation_project\project_folder\ansible\modules\expect.py,138.0
ansible.modules.file.AnsibleModuleError.__init__,249,9,0,9,0,0,0,2.0,2.0,0.0,D:\BaiduNetdiskDownload\graduation_project\project_folder\ansible\modules\file.py,249.0
ansible.modules.file.AnsibleModuleError.__repr__,252,1,1,0,1,0,0,2.0,1.0,0.0,D:\BaiduNetdiskDownload\graduation_project\project_folder\ansible\modules\file.py,252.0
ansible.modules.file._ansible_excepthook,265,1,1,0,1,0,0,6.0,3.0,0.0,D:\BaiduNetdiskDownload\graduation_project\project_folder\ansible\modules\file.py,265.0
ansible.modules.file.additional_parameter_handling,273,3,2,1,2,0,0,44.0,1.0,0.0,D:\BaiduNetdiskDownload\graduation_project\project_folder\ansible\modules\file.py,273.0
ansible.modules.file.check_group_exists,904,1,0,1,0,0,0,12.0,2.0,0.0,D:\BaiduNetdiskDownload\graduation_project\project_folder\ansible\modules\file.py,904.0
ansible.modules.file.check_owner_exists,890,1,0,1,0,0,0,12.0,2.0,0.0,D:\BaiduNetdiskDownload\graduation_project\project_folder\ansible\modules\file.py,890.0
ansible.modules.file.ensure_absent,520,5,4,1,4,0,0,27.0,1.0,0.0,D:\BaiduNetdiskDownload\graduation_project\project_folder\ansible\modules\file.py,520.0
ansible.modules.file.ensure_directory,618,14,13,1,13,0,0,69.0,4.0,0.0,D:\BaiduNetdiskDownload\graduation_project\project_folder\ansible\modules\file.py,618.0
ansible.modules.file.ensure_file_attributes,592,9,8,1,8,0,0,24.0,3.0,0.0,D:\BaiduNetdiskDownload\graduation_project\project_folder\ansible\modules\file.py,592.0
ansible.modules.file.ensure_hardlink,800,10,9,1,9,0,0,88.0,5.0,0.0,D:\BaiduNetdiskDownload\graduation_project\project_folder\ansible\modules\file.py,800.0
ansible.modules.file.ensure_symlink,689,10,9,1,9,0,0,109.0,5.0,0.0,D:\BaiduNetdiskDownload\graduation_project\project_folder\ansible\modules\file.py,689.0
ansible.modules.file.execute_diff_peek,503,3,2,1,2,0,0,15.0,1.0,0.0,D:\BaiduNetdiskDownload\graduation_project\project_folder\ansible\modules\file.py,503.0
ansible.modules.file.execute_touch,549,9,8,1,8,0,0,41.0,3.0,0.0,D:\BaiduNetdiskDownload\graduation_project\project_folder\ansible\modules\file.py,549.0
ansible.modules.file.get_state,319,8,1,7,1,0,0,22.0,1.0,0.0,D:\BaiduNetdiskDownload\graduation_project\project_folder\ansible\modules\file.py,319.0
ansible.modules.file.get_timestamp_for_time,419,6,1,5,1,0,0,14.0,2.0,0.0,D:\BaiduNetdiskDownload\graduation_project\project_folder\ansible\modules\file.py,419.0
ansible.modules.file.initial_diff,387,8,2,6,2,0,0,26.0,3.0,0.0,D:\BaiduNetdiskDownload\graduation_project\project_folder\ansible\modules\file.py,387.0
ansible.modules.file.keep_backward_compatibility_on_timestamps,494,1,0,1,0,0,0,7.0,2.0,0.0,D:\BaiduNetdiskDownload\graduation_project\project_folder\ansible\modules\file.py,494.0
ansible.modules.file.main,918,16,15,1,15,0,0,67.0,1.0,0.0,D:\BaiduNetdiskDownload\graduation_project\project_folder\ansible\modules\file.py,918.0
ansible.modules.file.recursive_set_attributes,344,6,4,2,4,1,1,41.0,5.0,0.0,D:\BaiduNetdiskDownload\graduation_project\project_folder\ansible\modules\file.py,344.0
ansible.modules.file.update_timestamp_for_file,435,8,2,6,2,0,0,57.0,3.0,0.0,D:\BaiduNetdiskDownload\graduation_project\project_folder\ansible\modules\file.py,435.0
ansible.modules.find._Object.__init__,280,2,1,1,1,0,0,3.0,2.0,0.0,D:\BaiduNetdiskDownload\graduation_project\project_folder\ansible\modules\find.py,280.0
ansible.modules.find.agefilter,324,1,0,1,0,0,0,9.0,4.0,0.0,D:\BaiduNetdiskDownload\graduation_project\project_folder\ansible\modules\find.py,324.0
ansible.modules.find.contentfilter,346,4,3,1,3,0,0,35.0,3.0,0.0,D:\BaiduNetdiskDownload\graduation_project\project_folder\ansible\modules\find.py,346.0
ansible.modules.find.main,450,17,16,1,16,0,0,160.0,1.0,2.0,D:\BaiduNetdiskDownload\graduation_project\project_folder\ansible\modules\find.py,450.0
ansible.modules.find.mode_filter,383,3,2,1,2,0,0,17.0,4.0,0.0,D:\BaiduNetdiskDownload\graduation_project\project_folder\ansible\modules\find.py,383.0
ansible.modules.find.pfilter,285,2,1,1,1,0,0,37.0,1.0,0.0,D:\BaiduNetdiskDownload\graduation_project\project_folder\ansible\modules\find.py,285.0
ansible.modules.find.sizefilter,335,1,0,1,0,0,0,9.0,2.0,0.0,D:\BaiduNetdiskDownload\graduation_project\project_folder\ansible\modules\find.py,335.0
ansible.modules.find.statinfo,402,1,0,1,0,0,0,46.0,1.0,0.0,D:\BaiduNetdiskDownload\graduation_project\project_folder\ansible\modules\find.py,402.0
ansible.modules.get_url.extract_filename_from_headers,439,1,0,1,0,0,0,18.0,1.0,0.0,D:\BaiduNetdiskDownload\graduation_project\project_folder\ansible\modules\get_url.py,439.0
ansible.modules.get_url.is_url,459,1,0,1,0,0,0,6.0,1.0,0.0,D:\BaiduNetdiskDownload\graduation_project\project_folder\ansible\modules\get_url.py,459.0
ansible.modules.get_url.main,470,24,23,1,23,0,0,234.0,1.0,0.0,D:\BaiduNetdiskDownload\graduation_project\project_folder\ansible\modules\get_url.py,470.0
ansible.modules.get_url.url_filename,384,1,0,1,0,0,0,5.0,1.0,0.0,D:\BaiduNetdiskDownload\graduation_project\project_folder\ansible\modules\get_url.py,384.0
ansible.modules.get_url.url_get,391,6,5,1,5,0,0,46.0,6.0,0.0,D:\BaiduNetdiskDownload\graduation_project\project_folder\ansible\modules\get_url.py,391.0
ansible.modules.getent.main,123,10,9,1,9,0,0,72.0,1.0,0.0,D:\BaiduNetdiskDownload\graduation_project\project_folder\ansible\modules\getent.py,123.0
ansible.modules.git.clone,572,10,9,1,9,0,0,69.0,16.0,0.0,D:\BaiduNetdiskDownload\graduation_project\project_folder\ansible\modules\git.py,572.0
ansible.modules.git.create_archive,1125,6,5,1,5,0,0,46.0,8.0,0.0,D:\BaiduNetdiskDownload\graduation_project\project_folder\ansible\modules\git.py,1125.0
ansible.modules.git.fetch,876,11,9,2,9,0,0,60.0,10.0,0.0,D:\BaiduNetdiskDownload\graduation_project\project_folder\ansible\modules\git.py,876.0
ansible.modules.git.get_annotated_tags,752,6,5,1,5,0,0,12.0,3.0,0.0,D:\BaiduNetdiskDownload\graduation_project\project_folder\ansible\modules\git.py,752.0
ansible.modules.git.get_branches,740,7,5,2,5,0,0,10.0,3.0,0.0,D:\BaiduNetdiskDownload\graduation_project\project_folder\ansible\modules\git.py,740.0
ansible.modules.git.get_diff,665,4,3,1,3,0,0,19.0,9.0,0.0,D:\BaiduNetdiskDownload\graduation_project\project_folder\ansible\modules\git.py,665.0
ansible.modules.git.get_gpg_fingerprint,1080,3,2,1,2,0,0,14.0,1.0,0.0,D:\BaiduNetdiskDownload\graduation_project\project_folder\ansible\modules\git.py,1080.0
ansible.modules.git.get_head_branch,819,8,5,3,5,0,0,26.0,4.0,0.0,D:\BaiduNetdiskDownload\graduation_project\project_folder\ansible\modules\git.py,819.0
ansible.modules.git.get_remote_head,686,8,7,1,7,0,0,43.0,6.0,0.0,D:\BaiduNetdiskDownload\graduation_project\project_folder\ansible\modules\git.py,686.0
ansible.modules.git.get_remote_url,847,4,2,2,2,0,0,9.0,4.0,0.0,D:\BaiduNetdiskDownload\graduation_project\project_folder\ansible\modules\git.py,847.0
ansible.modules.git.get_repo_path,794,5,3,2,3,0,0,23.0,2.0,0.0,D:\BaiduNetdiskDownload\graduation_project\project_folder\ansible\modules\git.py,794.0
ansible.modules.git.get_submodule_update_params,403,6,5,1,5,0,0,26.0,3.0,0.0,D:\BaiduNetdiskDownload\graduation_project\project_folder\ansible\modules\git.py,403.0
ansible.modules.git.get_submodule_versions,545,6,5,1,5,0,0,25.0,3.0,0.0,D:\BaiduNetdiskDownload\graduation_project\project_folder\ansible\modules\git.py,545.0
ansible.modules.git.get_version,521,5,2,3,2,0,0,7.0,3.0,0.0,D:\BaiduNetdiskDownload\graduation_project\project_folder\ansible\modules\git.py,521.0
ansible.modules.git.git_archive,1110,3,2,1,2,0,0,13.0,7.0,0.0,D:\BaiduNetdiskDownload\graduation_project\project_folder\ansible\modules\git.py,1110.0
ansible.modules.git.git_version,1096,5,3,2,3,0,0,12.0,2.0,0.0,D:\BaiduNetdiskDownload\graduation_project\project_folder\ansible\modules\git.py,1096.0
ansible.modules.git.has_local_mods,643,3,2,1,2,0,0,10.0,4.0,0.0,D:\BaiduNetdiskDownload\graduation_project\project_folder\ansible\modules\git.py,643.0
ansible.modules.git.head_splitter,368,5,4,1,4,0,0,25.0,2.0,0.0,D:\BaiduNetdiskDownload\graduation_project\project_folder\ansible\modules\git.py,368.0
ansible.modules.git.is_local_branch,775,2,1,1,1,0,0,9.0,4.0,0.0,D:\BaiduNetdiskDownload\graduation_project\project_folder\ansible\modules\git.py,775.0
ansible.modules.git.is_not_a_branch,786,3,2,1,2,0,0,6.0,3.0,0.0,D:\BaiduNetdiskDownload\graduation_project\project_folder\ansible\modules\git.py,786.0
ansible.modules.git.is_remote_branch,766,5,1,4,1,0,0,7.0,5.0,0.0,D:\BaiduNetdiskDownload\graduation_project\project_folder\ansible\modules\git.py,766.0
ansible.modules.git.is_remote_tag,731,4,1,3,1,0,0,7.0,5.0,0.0,D:\BaiduNetdiskDownload\graduation_project\project_folder\ansible\modules\git.py,731.0
ansible.modules.git.main,1175,29,28,1,28,0,0,252.0,1.0,0.0,D:\BaiduNetdiskDownload\graduation_project\project_folder\ansible\modules\git.py,1175.0
ansible.modules.git.relocate_repo,350,5,3,2,3,0,0,16.0,5.0,0.0,D:\BaiduNetdiskDownload\graduation_project\project_folder\ansible\modules\git.py,350.0
ansible.modules.git.reset,655,2,1,1,1,0,0,8.0,3.0,0.0,D:\BaiduNetdiskDownload\graduation_project\project_folder\ansible\modules\git.py,655.0
ansible.modules.git.set_git_ssh_env,468,3,2,1,2,0,0,51.0,4.0,0.0,D:\BaiduNetdiskDownload\graduation_project\project_folder\ansible\modules\git.py,468.0
ansible.modules.git.set_remote_branch,1006,3,2,1,2,0,0,13.0,6.0,0.0,D:\BaiduNetdiskDownload\graduation_project\project_folder\ansible\modules\git.py,1006.0
ansible.modules.git.set_remote_url,858,6,4,2,4,0,0,16.0,5.0,0.0,D:\BaiduNetdiskDownload\graduation_project\project_folder\ansible\modules\git.py,858.0
ansible.modules.git.ssh_supports_acceptnewhostkey,530,5,4,1,4,0,0,13.0,1.0,0.0,D:\BaiduNetdiskDownload\graduation_project\project_folder\ansible\modules\git.py,530.0
ansible.modules.git.submodule_update,983,5,4,1,4,0,0,21.0,4.0,0.0,D:\BaiduNetdiskDownload\graduation_project\project_folder\ansible\modules\git.py,983.0
ansible.modules.git.submodules_fetch,938,8,7,1,7,0,0,43.0,5.0,0.0,D:\BaiduNetdiskDownload\graduation_project\project_folder\ansible\modules\git.py,938.0
ansible.modules.git.switch_version,1021,8,7,1,7,0,0,39.0,8.0,0.0,D:\BaiduNetdiskDownload\graduation_project\project_folder\ansible\modules\git.py,1021.0
ansible.modules.git.unfrackgitpath,395,2,0,2,0,0,0,6.0,1.0,0.0,D:\BaiduNetdiskDownload\graduation_project\project_folder\ansible\modules\git.py,395.0
ansible.modules.git.verify_commit_sign,1062,6,4,2,4,0,0,16.0,5.0,0.0,D:\BaiduNetdiskDownload\graduation_project\project_folder\ansible\modules\git.py,1062.0
ansible.modules.git.write_ssh_wrapper,431,4,3,1,3,0,0,35.0,1.0,0.0,D:\BaiduNetdiskDownload\graduation_project\project_folder\ansible\modules\git.py,431.0
ansible.modules.group.AIX.group_add,319,2,2,0,2,0,0,9.0,2.0,0.0,D:\BaiduNetdiskDownload\graduation_project\project_folder\ansible\modules\group.py,319.0
ansible.modules.group.AIX.group_del,315,1,1,0,1,0,0,3.0,1.0,0.0,D:\BaiduNetdiskDownload\graduation_project\project_folder\ansible\modules\group.py,315.0
ansible.modules.group.AIX.group_mod,329,3,3,0,3,0,0,13.0,2.0,0.0,D:\BaiduNetdiskDownload\graduation_project\project_folder\ansible\modules\group.py,329.0
ansible.modules.group.BusyBoxGroup.group_add,573,3,3,0,3,0,0,11.0,2.0,0.0,D:\BaiduNetdiskDownload\graduation_project\project_folder\ansible\modules\group.py,573.0
ansible.modules.group.BusyBoxGroup.group_del,585,1,1,0,1,0,0,3.0,1.0,0.0,D:\BaiduNetdiskDownload\graduation_project\project_folder\ansible\modules\group.py,585.0
ansible.modules.group.BusyBoxGroup.group_mod,589,7,7,0,7,0,0,22.0,2.0,0.0,D:\BaiduNetdiskDownload\graduation_project\project_folder\ansible\modules\group.py,589.0
ansible.modules.group.DarwinGroup.get_lowest_available_system_gid,449,4,3,1,3,0,0,19.0,1.0,0.0,D:\BaiduNetdiskDownload\graduation_project\project_folder\ansible\modules\group.py,449.0
ansible.modules.group.DarwinGroup.group_add,416,2,2,0,2,0,0,13.0,2.0,0.0,D:\BaiduNetdiskDownload\graduation_project\project_folder\ansible\modules\group.py,416.0
ansible.modules.group.DarwinGroup.group_del,430,1,1,0,1,0,0,6.0,1.0,0.0,D:\BaiduNetdiskDownload\graduation_project\project_folder\ansible\modules\group.py,430.0
ansible.modules.group.DarwinGroup.group_mod,437,2,2,0,2,0,0,11.0,1.0,0.0,D:\BaiduNetdiskDownload\graduation_project\project_folder\ansible\modules\group.py,437.0
ansible.modules.group.FreeBsdGroup.group_add,364,2,2,0,2,0,0,8.0,2.0,0.0,D:\BaiduNetdiskDownload\graduation_project\project_folder\ansible\modules\group.py,364.0
ansible.modules.group.FreeBsdGroup.group_del,360,1,1,0,1,0,0,3.0,1.0,0.0,D:\BaiduNetdiskDownload\graduation_project\project_folder\ansible\modules\group.py,360.0
ansible.modules.group.FreeBsdGroup.group_mod,373,3,3,0,3,0,0,15.0,2.0,0.0,D:\BaiduNetdiskDownload\graduation_project\project_folder\ansible\modules\group.py,373.0
ansible.modules.group.Group.__new__,141,2,1,1,1,0,0,3.0,3.0,0.0,D:\BaiduNetdiskDownload\graduation_project\project_folder\ansible\modules\group.py,141.0
ansible.modules.group.Group._local_check_gid_exists,166,4,2,2,2,0,0,5.0,1.0,0.0,D:\BaiduNetdiskDownload\graduation_project\project_folder\ansible\modules\group.py,166.0
ansible.modules.group.Group.execute_command,155,24,1,23,1,0,0,2.0,2.0,0.0,D:\BaiduNetdiskDownload\graduation_project\project_folder\ansible\modules\group.py,155.0
ansible.modules.group.Group.group_add,172,4,3,1,3,0,0,17.0,2.0,0.0,D:\BaiduNetdiskDownload\graduation_project\project_folder\ansible\modules\group.py,172.0
ansible.modules.group.Group.group_del,158,2,1,1,1,0,0,7.0,1.0,0.0,D:\BaiduNetdiskDownload\graduation_project\project_folder\ansible\modules\group.py,158.0
ansible.modules.group.Group.group_exists,212,6,4,2,4,0,0,24.0,1.0,0.0,D:\BaiduNetdiskDownload\graduation_project\project_folder\ansible\modules\group.py,212.0
ansible.modules.group.Group.group_info,237,9,1,8,1,0,0,8.0,1.0,0.0,D:\BaiduNetdiskDownload\graduation_project\project_folder\ansible\modules\group.py,237.0
ansible.modules.group.Group.group_mod,190,5,4,1,4,0,0,21.0,2.0,0.0,D:\BaiduNetdiskDownload\graduation_project\project_folder\ansible\modules\group.py,190.0
ansible.modules.group.Linux.group_del,260,2,2,0,2,0,0,10.0,1.0,0.0,D:\BaiduNetdiskDownload\graduation_project\project_folder\ansible\modules\group.py,260.0
ansible.modules.group.NetBsdGroup.group_add,534,2,2,0,2,0,0,9.0,2.0,0.0,D:\BaiduNetdiskDownload\graduation_project\project_folder\ansible\modules\group.py,534.0
ansible.modules.group.NetBsdGroup.group_del,530,1,1,0,1,0,0,3.0,1.0,0.0,D:\BaiduNetdiskDownload\graduation_project\project_folder\ansible\modules\group.py,530.0
ansible.modules.group.NetBsdGroup.group_mod,544,3,3,0,3,0,0,14.0,2.0,0.0,D:\BaiduNetdiskDownload\graduation_project\project_folder\ansible\modules\group.py,544.0
ansible.modules.group.OpenBsdGroup.group_add,488,2,2,0,2,0,0,9.0,2.0,0.0,D:\BaiduNetdiskDownload\graduation_project\project_folder\ansible\modules\group.py,488.0
ansible.modules.group.OpenBsdGroup.group_del,484,1,1,0,1,0,0,3.0,1.0,0.0,D:\BaiduNetdiskDownload\graduation_project\project_folder\ansible\modules\group.py,484.0
ansible.modules.group.OpenBsdGroup.group_mod,498,3,3,0,3,0,0,14.0,2.0,0.0,D:\BaiduNetdiskDownload\graduation_project\project_folder\ansible\modules\group.py,498.0
ansible.modules.group.SunOS.group_add,287,2,2,0,2,0,0,10.0,2.0,0.0,D:\BaiduNetdiskDownload\graduation_project\project_folder\ansible\modules\group.py,287.0
ansible.modules.group.main,619,11,10,1,10,0,0,69.0,1.0,0.0,D:\BaiduNetdiskDownload\graduation_project\project_folder\ansible\modules\group.py,619.0
ansible.modules.hostname.AlpineStrategy.set_current_hostname,286,2,2,0,2,0,0,8.0,2.0,0.0,D:\BaiduNetdiskDownload\graduation_project\project_folder\ansible\modules\hostname.py,286.0
ansible.modules.hostname.BaseStrategy.get_current_hostname,128,2,1,1,1,0,0,2.0,1.0,0.0,D:\BaiduNetdiskDownload\graduation_project\project_folder\ansible\modules\hostname.py,128.0
ansible.modules.hostname.BaseStrategy.get_permanent_hostname,134,2,0,2,0,0,0,2.0,1.0,0.0,D:\BaiduNetdiskDownload\graduation_project\project_folder\ansible\modules\hostname.py,134.0
ansible.modules.hostname.BaseStrategy.set_current_hostname,131,1,0,1,0,0,0,2.0,2.0,0.0,D:\BaiduNetdiskDownload\graduation_project\project_folder\ansible\modules\hostname.py,131.0
ansible.modules.hostname.BaseStrategy.set_permanent_hostname,137,1,0,1,0,0,0,2.0,2.0,0.0,D:\BaiduNetdiskDownload\graduation_project\project_folder\ansible\modules\hostname.py,137.0
ansible.modules.hostname.BaseStrategy.update_current_and_permanent_hostname,107,2,2,0,2,0,0,4.0,1.0,0.0,D:\BaiduNetdiskDownload\graduation_project\project_folder\ansible\modules\hostname.py,107.0
ansible.modules.hostname.BaseStrategy.update_current_hostname,112,4,2,2,2,0,0,7.0,1.0,0.0,D:\BaiduNetdiskDownload\graduation_project\project_folder\ansible\modules\hostname.py,112.0
ansible.modules.hostname.BaseStrategy.update_permanent_hostname,120,4,2,2,2,0,0,7.0,1.0,0.0,D:\BaiduNetdiskDownload\graduation_project\project_folder\ansible\modules\hostname.py,120.0
ansible.modules.hostname.CommandStrategy.get_current_hostname,181,3,3,0,3,0,0,6.0,1.0,0.0,D:\BaiduNetdiskDownload\graduation_project\project_folder\ansible\modules\hostname.py,181.0
ansible.modules.hostname.CommandStrategy.set_current_hostname,188,2,2,0,2,0,0,5.0,2.0,0.0,D:\BaiduNetdiskDownload\graduation_project\project_folder\ansible\modules\hostname.py,188.0
ansible.modules.hostname.DarwinStrategy.__init__,527,1,1,0,1,0,0,6.0,2.0,0.0,D:\BaiduNetdiskDownload\graduation_project\project_folder\ansible\modules\hostname.py,527.0
ansible.modules.hostname.DarwinStrategy._scrub_hostname,534,5,4,1,4,0,0,20.0,2.0,0.0,D:\BaiduNetdiskDownload\graduation_project\project_folder\ansible\modules\hostname.py,534.0
ansible.modules.hostname.DarwinStrategy.get_current_hostname,555,3,3,0,3,0,0,7.0,1.0,0.0,D:\BaiduNetdiskDownload\graduation_project\project_folder\ansible\modules\hostname.py,555.0
ansible.modules.hostname.DarwinStrategy.get_permanent_hostname,563,3,3,0,3,0,0,7.0,1.0,0.0,D:\BaiduNetdiskDownload\graduation_project\project_folder\ansible\modules\hostname.py,563.0
ansible.modules.hostname.DarwinStrategy.set_permanent_hostname,571,5,4,1,4,0,0,10.0,2.0,0.0,D:\BaiduNetdiskDownload\graduation_project\project_folder\ansible\modules\hostname.py,571.0
ansible.modules.hostname.DarwinStrategy.update_permanent_hostname,588,3,3,0,3,0,0,14.0,1.0,0.0,D:\BaiduNetdiskDownload\graduation_project\project_folder\ansible\modules\hostname.py,588.0
ansible.modules.hostname.FileStrategy.get_permanent_hostname,204,2,2,0,2,0,0,10.0,1.0,0.0,D:\BaiduNetdiskDownload\graduation_project\project_folder\ansible\modules\hostname.py,204.0
ansible.modules.hostname.FileStrategy.set_permanent_hostname,215,2,2,0,2,0,0,8.0,2.0,0.0,D:\BaiduNetdiskDownload\graduation_project\project_folder\ansible\modules\hostname.py,215.0
ansible.modules.hostname.FreeBSDStrategy.get_current_hostname,461,3,3,0,3,0,0,6.0,1.0,0.0,D:\BaiduNetdiskDownload\graduation_project\project_folder\ansible\modules\hostname.py,461.0
ansible.modules.hostname.FreeBSDStrategy.get_permanent_hostname,474,4,4,0,4,0,0,13.0,1.0,0.0,D:\BaiduNetdiskDownload\graduation_project\project_folder\ansible\modules\hostname.py,474.0
ansible.modules.hostname.FreeBSDStrategy.set_current_hostname,468,2,2,0,2,0,0,5.0,2.0,0.0,D:\BaiduNetdiskDownload\graduation_project\project_folder\ansible\modules\hostname.py,468.0
ansible.modules.hostname.FreeBSDStrategy.set_permanent_hostname,488,6,6,0,6,0,0,18.0,2.0,0.0,D:\BaiduNetdiskDownload\graduation_project\project_folder\ansible\modules\hostname.py,488.0
ansible.modules.hostname.Hostname.__init__,622,2,2,0,2,0,0,13.0,2.0,0.0,D:\BaiduNetdiskDownload\graduation_project\project_folder\ansible\modules\hostname.py,622.0
ansible.modules.hostname.Hostname.__new__,618,2,1,1,1,0,0,3.0,3.0,0.0,D:\BaiduNetdiskDownload\graduation_project\project_folder\ansible\modules\hostname.py,618.0
ansible.modules.hostname.Hostname.get_current_hostname,639,3,1,2,1,1,1,2.0,1.0,0.0,D:\BaiduNetdiskDownload\graduation_project\project_folder\ansible\modules\hostname.py,639.0
ansible.modules.hostname.Hostname.get_permanent_hostname,645,3,1,2,1,1,1,2.0,1.0,0.0,D:\BaiduNetdiskDownload\graduation_project\project_folder\ansible\modules\hostname.py,645.0
ansible.modules.hostname.Hostname.set_current_hostname,642,2,1,1,1,1,1,2.0,2.0,0.0,D:\BaiduNetdiskDownload\graduation_project\project_folder\ansible\modules\hostname.py,642.0
ansible.modules.hostname.Hostname.set_permanent_hostname,648,2,1,1,1,1,1,2.0,2.0,0.0,D:\BaiduNetdiskDownload\graduation_project\project_folder\ansible\modules\hostname.py,648.0
ansible.modules.hostname.Hostname.update_current_and_permanent_hostname,636,3,1,2,1,1,1,2.0,1.0,0.0,D:\BaiduNetdiskDownload\graduation_project\project_folder\ansible\modules\hostname.py,636.0
ansible.modules.hostname.OpenBSDStrategy.get_current_hostname,399,3,3,0,3,0,0,6.0,1.0,0.0,D:\BaiduNetdiskDownload\graduation_project\project_folder\ansible\modules\hostname.py,399.0
ansible.modules.hostname.OpenBSDStrategy.set_current_hostname,406,2,2,0,2,0,0,5.0,2.0,0.0,D:\BaiduNetdiskDownload\graduation_project\project_folder\ansible\modules\hostname.py,406.0
ansible.modules.hostname.OpenRCStrategy.get_permanent_hostname,354,4,4,0,4,0,0,13.0,1.0,0.0,D:\BaiduNetdiskDownload\graduation_project\project_folder\ansible\modules\hostname.py,354.0
ansible.modules.hostname.OpenRCStrategy.set_permanent_hostname,368,6,6,0,6,0,0,15.0,2.0,0.0,D:\BaiduNetdiskDownload\graduation_project\project_folder\ansible\modules\hostname.py,368.0
ansible.modules.hostname.RedHatStrategy.get_permanent_hostname,240,5,5,0,5,0,0,14.0,1.0,0.0,D:\BaiduNetdiskDownload\graduation_project\project_folder\ansible\modules\hostname.py,240.0
ansible.modules.hostname.RedHatStrategy.set_permanent_hostname,255,6,6,0,6,0,0,20.0,2.0,0.0,D:\BaiduNetdiskDownload\graduation_project\project_folder\ansible\modules\hostname.py,255.0
ansible.modules.hostname.SolarisStrategy.get_permanent_hostname,432,3,3,0,3,0,0,8.0,1.0,0.0,D:\BaiduNetdiskDownload\graduation_project\project_folder\ansible\modules\hostname.py,432.0
ansible.modules.hostname.SolarisStrategy.set_current_hostname,425,2,2,0,2,0,0,6.0,2.0,0.0,D:\BaiduNetdiskDownload\graduation_project\project_folder\ansible\modules\hostname.py,425.0
ansible.modules.hostname.SolarisStrategy.set_permanent_hostname,441,2,2,0,2,0,0,5.0,2.0,0.0,D:\BaiduNetdiskDownload\graduation_project\project_folder\ansible\modules\hostname.py,441.0
ansible.modules.hostname.SystemdStrategy.__init__,304,1,0,1,0,0,0,3.0,2.0,0.0,D:\BaiduNetdiskDownload\graduation_project\project_folder\ansible\modules\hostname.py,304.0
ansible.modules.hostname.SystemdStrategy.get_current_hostname,308,3,3,0,3,0,0,6.0,1.0,0.0,D:\BaiduNetdiskDownload\graduation_project\project_folder\ansible\modules\hostname.py,308.0
ansible.modules.hostname.SystemdStrategy.get_permanent_hostname,323,3,3,0,3,0,0,6.0,1.0,0.0,D:\BaiduNetdiskDownload\graduation_project\project_folder\ansible\modules\hostname.py,323.0
ansible.modules.hostname.SystemdStrategy.set_current_hostname,315,2,2,0,2,0,0,7.0,2.0,0.0,D:\BaiduNetdiskDownload\graduation_project\project_folder\ansible\modules\hostname.py,315.0
ansible.modules.hostname.SystemdStrategy.set_permanent_hostname,330,2,2,0,2,0,0,7.0,2.0,0.0,D:\BaiduNetdiskDownload\graduation_project\project_folder\ansible\modules\hostname.py,330.0
ansible.modules.hostname.SystemdStrategy.update_current_and_permanent_hostname,338,2,2,0,2,0,0,6.0,1.0,0.0,D:\BaiduNetdiskDownload\graduation_project\project_folder\ansible\modules\hostname.py,338.0
ansible.modules.hostname.UnimplementedStrategy.get_current_hostname,151,1,1,0,1,0,0,2.0,1.0,0.0,D:\BaiduNetdiskDownload\graduation_project\project_folder\ansible\modules\hostname.py,151.0
ansible.modules.hostname.UnimplementedStrategy.get_permanent_hostname,157,1,1,0,1,0,0,2.0,1.0,0.0,D:\BaiduNetdiskDownload\graduation_project\project_folder\ansible\modules\hostname.py,157.0
ansible.modules.hostname.UnimplementedStrategy.set_current_hostname,154,1,1,0,1,0,0,2.0,2.0,0.0,D:\BaiduNetdiskDownload\graduation_project\project_folder\ansible\modules\hostname.py,154.0
ansible.modules.hostname.UnimplementedStrategy.set_permanent_hostname,160,1,1,0,1,0,0,2.0,2.0,0.0,D:\BaiduNetdiskDownload\graduation_project\project_folder\ansible\modules\hostname.py,160.0
ansible.modules.hostname.UnimplementedStrategy.unimplemented_error,163,9,2,7,2,0,0,9.0,1.0,0.0,D:\BaiduNetdiskDownload\graduation_project\project_folder\ansible\modules\hostname.py,163.0
ansible.modules.hostname.UnimplementedStrategy.update_current_and_permanent_hostname,142,1,1,0,1,0,0,2.0,1.0,0.0,D:\BaiduNetdiskDownload\graduation_project\project_folder\ansible\modules\hostname.py,142.0
ansible.modules.hostname.UnimplementedStrategy.update_current_hostname,145,1,1,0,1,0,0,2.0,1.0,0.0,D:\BaiduNetdiskDownload\graduation_project\project_folder\ansible\modules\hostname.py,145.0
ansible.modules.hostname.UnimplementedStrategy.update_permanent_hostname,148,1,1,0,1,0,0,2.0,1.0,0.0,D:\BaiduNetdiskDownload\graduation_project\project_folder\ansible\modules\hostname.py,148.0
ansible.modules.hostname.main,870,9,8,1,8,0,0,37.0,1.0,0.0,D:\BaiduNetdiskDownload\graduation_project\project_folder\ansible\modules\hostname.py,870.0
ansible.modules.iptables.append_csv,595,3,2,1,2,0,0,3.0,3.0,0.0,D:\BaiduNetdiskDownload\graduation_project\project_folder\ansible\modules\iptables.py,595.0
ansible.modules.iptables.append_jump,605,2,1,1,1,0,0,3.0,3.0,0.0,D:\BaiduNetdiskDownload\graduation_project\project_folder\ansible\modules\iptables.py,605.0
ansible.modules.iptables.append_match,600,2,1,1,1,0,0,5.0,4.0,0.0,D:\BaiduNetdiskDownload\graduation_project\project_folder\ansible\modules\iptables.py,588.0
ansible.modules.iptables.append_match_flag,588,2,1,1,1,0,0,5.0,4.0,0.0,D:\BaiduNetdiskDownload\graduation_project\project_folder\ansible\modules\iptables.py,588.0
ansible.modules.iptables.append_param,570,4,2,2,2,1,1,10.0,4.0,0.0,D:\BaiduNetdiskDownload\graduation_project\project_folder\ansible\modules\iptables.py,570.0
ansible.modules.iptables.append_rule,715,3,2,1,2,0,0,3.0,3.0,0.0,D:\BaiduNetdiskDownload\graduation_project\project_folder\ansible\modules\iptables.py,715.0
ansible.modules.iptables.append_tcp_flags,582,3,2,1,2,0,0,4.0,3.0,0.0,D:\BaiduNetdiskDownload\graduation_project\project_folder\ansible\modules\iptables.py,582.0
ansible.modules.iptables.append_wait,610,2,1,1,1,0,0,3.0,3.0,0.0,D:\BaiduNetdiskDownload\graduation_project\project_folder\ansible\modules\iptables.py,610.0
ansible.modules.iptables.check_chain_present,764,4,3,1,3,0,0,6.0,3.0,0.0,D:\BaiduNetdiskDownload\graduation_project\project_folder\ansible\modules\iptables.py,764.0
ansible.modules.iptables.check_rule_present,709,3,2,1,2,0,0,4.0,3.0,0.0,D:\BaiduNetdiskDownload\graduation_project\project_folder\ansible\modules\iptables.py,709.0
ansible.modules.iptables.construct_rule,615,10,8,2,8,0,0,81.0,1.0,0.0,D:\BaiduNetdiskDownload\graduation_project\project_folder\ansible\modules\iptables.py,615.0
ansible.modules.iptables.create_chain,759,3,2,1,2,0,0,3.0,3.0,0.0,D:\BaiduNetdiskDownload\graduation_project\project_folder\ansible\modules\iptables.py,759.0
ansible.modules.iptables.delete_chain,772,3,2,1,2,0,0,3.0,3.0,0.0,D:\BaiduNetdiskDownload\graduation_project\project_folder\ansible\modules\iptables.py,772.0
ansible.modules.iptables.flush_table,730,3,2,1,2,0,0,3.0,3.0,0.0,D:\BaiduNetdiskDownload\graduation_project\project_folder\ansible\modules\iptables.py,730.0
ansible.modules.iptables.get_chain_policy,741,5,4,1,4,0,0,10.0,3.0,0.0,D:\BaiduNetdiskDownload\graduation_project\project_folder\ansible\modules\iptables.py,741.0
ansible.modules.iptables.get_iptables_version,753,4,3,1,3,0,0,4.0,2.0,0.0,D:\BaiduNetdiskDownload\graduation_project\project_folder\ansible\modules\iptables.py,753.0
ansible.modules.iptables.insert_rule,720,3,2,1,2,0,0,3.0,3.0,0.0,D:\BaiduNetdiskDownload\graduation_project\project_folder\ansible\modules\iptables.py,720.0
ansible.modules.iptables.main,777,19,18,1,18,0,0,172.0,1.0,0.0,D:\BaiduNetdiskDownload\graduation_project\project_folder\ansible\modules\iptables.py,777.0
ansible.modules.iptables.push_arguments,698,12,2,10,2,0,0,9.0,3.0,0.0,D:\BaiduNetdiskDownload\graduation_project\project_folder\ansible\modules\iptables.py,698.0
ansible.modules.iptables.remove_rule,725,3,2,1,2,0,0,3.0,3.0,0.0,D:\BaiduNetdiskDownload\graduation_project\project_folder\ansible\modules\iptables.py,725.0
ansible.modules.iptables.set_chain_policy,735,4,3,1,3,0,0,4.0,3.0,0.0,D:\BaiduNetdiskDownload\graduation_project\project_folder\ansible\modules\iptables.py,735.0
ansible.modules.known_hosts.compute_diff,330,5,4,1,4,0,0,22.0,5.0,0.0,D:\BaiduNetdiskDownload\graduation_project\project_folder\ansible\modules\known_hosts.py,330.0
ansible.modules.known_hosts.enforce_state,116,12,11,1,11,0,0,78.0,2.0,0.0,D:\BaiduNetdiskDownload\graduation_project\project_folder\ansible\modules\known_hosts.py,116.0
ansible.modules.known_hosts.hash_host_key,295,5,4,1,4,0,0,8.0,2.0,0.0,D:\BaiduNetdiskDownload\graduation_project\project_folder\ansible\modules\known_hosts.py,295.0
ansible.modules.known_hosts.main,354,4,3,1,3,0,0,15.0,1.0,0.0,D:\BaiduNetdiskDownload\graduation_project\project_folder\ansible\modules\known_hosts.py,354.0
ansible.modules.known_hosts.normalize_known_hosts_key,305,3,2,1,2,0,0,23.0,1.0,0.0,D:\BaiduNetdiskDownload\graduation_project\project_folder\ansible\modules\known_hosts.py,305.0
ansible.modules.known_hosts.sanity_check,196,4,3,1,3,0,0,35.0,4.0,0.0,D:\BaiduNetdiskDownload\graduation_project\project_folder\ansible\modules\known_hosts.py,196.0
ansible.modules.known_hosts.search_for_host_key,233,5,4,1,4,0,0,60.0,5.0,0.0,D:\BaiduNetdiskDownload\graduation_project\project_folder\ansible\modules\known_hosts.py,233.0
ansible.modules.lineinfile.absent,504,10,9,1,9,0,0,59.0,6.0,2.0,D:\BaiduNetdiskDownload\graduation_project\project_folder\ansible\modules\lineinfile.py,504.0
ansible.modules.lineinfile.check_file_attrs,278,4,2,2,2,0,0,11.0,4.0,0.0,D:\BaiduNetdiskDownload\graduation_project\project_folder\ansible\modules\lineinfile.py,278.0
ansible.modules.lineinfile.main,565,7,6,1,6,0,0,65.0,1.0,0.0,D:\BaiduNetdiskDownload\graduation_project\project_folder\ansible\modules\lineinfile.py,565.0
ansible.modules.lineinfile.present,291,13,12,1,12,0,0,211.0,11.0,0.0,D:\BaiduNetdiskDownload\graduation_project\project_folder\ansible\modules\lineinfile.py,291.0
ansible.modules.lineinfile.write_changes,256,6,4,2,4,0,0,20.0,3.0,0.0,D:\BaiduNetdiskDownload\graduation_project\project_folder\ansible\modules\lineinfile.py,256.0
ansible.modules.package_facts.APK.get_package_details,467,1,1,0,1,0,0,11.0,2.0,0.0,D:\BaiduNetdiskDownload\graduation_project\project_folder\ansible\modules\package_facts.py,467.0
ansible.modules.package_facts.APK.list_installed,461,2,2,0,2,0,0,5.0,1.0,0.0,D:\BaiduNetdiskDownload\graduation_project\project_folder\ansible\modules\package_facts.py,461.0
ansible.modules.package_facts.APT.is_available,325,5,5,0,5,0,0,23.0,1.0,0.0,D:\BaiduNetdiskDownload\graduation_project\project_folder\ansible\modules\package_facts.py,325.0
ansible.modules.package_facts.PACMAN.get_package_details,370,3,3,0,3,0,0,26.0,2.0,0.0,D:\BaiduNetdiskDownload\graduation_project\project_folder\ansible\modules\package_facts.py,370.0
ansible.modules.package_facts.PACMAN.list_installed,363,3,3,0,3,0,0,6.0,1.0,0.0,D:\BaiduNetdiskDownload\graduation_project\project_folder\ansible\modules\package_facts.py,363.0
ansible.modules.package_facts.PKG.get_package_details,409,1,1,0,1,0,0,31.0,2.0,0.0,D:\BaiduNetdiskDownload\graduation_project\project_folder\ansible\modules\package_facts.py,409.0
ansible.modules.package_facts.PKG.list_installed,403,3,3,0,3,0,0,5.0,1.0,0.0,D:\BaiduNetdiskDownload\graduation_project\project_folder\ansible\modules\package_facts.py,403.0
ansible.modules.package_facts.PKG_INFO.get_package_details,490,2,2,0,2,0,0,11.0,2.0,0.0,D:\BaiduNetdiskDownload\graduation_project\project_folder\ansible\modules\package_facts.py,490.0
ansible.modules.package_facts.PKG_INFO.list_installed,484,2,2,0,2,0,0,5.0,1.0,0.0,D:\BaiduNetdiskDownload\graduation_project\project_folder\ansible\modules\package_facts.py,484.0
ansible.modules.package_facts.PORTAGE.get_package_details,453,1,1,0,1,0,0,2.0,2.0,0.0,D:\BaiduNetdiskDownload\graduation_project\project_folder\ansible\modules\package_facts.py,453.0
ansible.modules.package_facts.PORTAGE.list_installed,447,3,3,0,3,0,0,5.0,1.0,0.0,D:\BaiduNetdiskDownload\graduation_project\project_folder\ansible\modules\package_facts.py,447.0
ansible.modules.package_facts.RPM.is_available,284,5,5,0,5,0,0,23.0,1.0,0.0,D:\BaiduNetdiskDownload\graduation_project\project_folder\ansible\modules\package_facts.py,284.0
ansible.modules.package_facts.main,503,13,12,1,12,0,0,78.0,1.0,0.0,D:\BaiduNetdiskDownload\graduation_project\project_folder\ansible\modules\package_facts.py,503.0
ansible.modules.ping.main,69,3,2,1,2,0,0,16.0,1.0,0.0,D:\BaiduNetdiskDownload\graduation_project\project_folder\ansible\modules\ping.py,69.0
ansible.modules.pip.Package.__init__,627,5,4,1,4,0,0,22.0,2.0,0.0,D:\BaiduNetdiskDownload\graduation_project\project_folder\ansible\modules\pip.py,627.0
ansible.modules.pip.Package.canonicalize_name,670,3,1,2,1,0,0,3.0,1.0,0.0,D:\BaiduNetdiskDownload\graduation_project\project_folder\ansible\modules\pip.py,670.0
ansible.modules.pip.Package.is_satisfied_by,656,1,1,0,1,0,0,12.0,2.0,0.0,D:\BaiduNetdiskDownload\graduation_project\project_folder\ansible\modules\pip.py,656.0
ansible.modules.pip._fail,533,4,1,3,1,0,0,7.0,4.0,0.0,D:\BaiduNetdiskDownload\graduation_project\project_folder\ansible\modules\pip.py,533.0
ansible.modules.pip._get_cmd_options,408,6,5,1,5,0,0,9.0,2.0,0.0,D:\BaiduNetdiskDownload\graduation_project\project_folder\ansible\modules\pip.py,408.0
ansible.modules.pip._get_package_info,542,3,2,1,2,0,0,22.0,2.0,0.0,D:\BaiduNetdiskDownload\graduation_project\project_folder\ansible\modules\pip.py,542.0
ansible.modules.pip._get_packages,419,5,4,1,4,0,0,16.0,3.0,0.0,D:\BaiduNetdiskDownload\graduation_project\project_folder\ansible\modules\pip.py,419.0
ansible.modules.pip._get_pip,452,5,4,1,4,0,0,49.0,1.0,0.0,D:\BaiduNetdiskDownload\graduation_project\project_folder\ansible\modules\pip.py,452.0
ansible.modules.pip._have_pip_module,503,1,0,1,0,0,0,28.0,1.0,0.0,D:\BaiduNetdiskDownload\graduation_project\project_folder\ansible\modules\pip.py,503.0
ansible.modules.pip._is_package_name,366,3,2,1,2,0,0,3.0,1.0,0.0,D:\BaiduNetdiskDownload\graduation_project\project_folder\ansible\modules\pip.py,366.0
ansible.modules.pip._is_present,437,3,2,1,2,0,0,13.0,4.0,0.0,D:\BaiduNetdiskDownload\graduation_project\project_folder\ansible\modules\pip.py,437.0
ansible.modules.pip._is_vcs_url,349,1,0,1,0,0,0,3.0,1.0,0.0,D:\BaiduNetdiskDownload\graduation_project\project_folder\ansible\modules\pip.py,349.0
ansible.modules.pip._is_venv_command,354,3,2,1,2,0,0,10.0,1.0,0.0,D:\BaiduNetdiskDownload\graduation_project\project_folder\ansible\modules\pip.py,354.0
ansible.modules.pip._recover_package_name,371,6,5,1,5,0,0,35.0,1.0,0.0,D:\BaiduNetdiskDownload\graduation_project\project_folder\ansible\modules\pip.py,371.0
ansible.modules.pip.main,680,21,20,1,20,0,0,204.0,1.0,0.0,D:\BaiduNetdiskDownload\graduation_project\project_folder\ansible\modules\pip.py,680.0
ansible.modules.pip.setup_virtualenv,566,9,8,1,8,0,0,49.0,5.0,0.0,D:\BaiduNetdiskDownload\graduation_project\project_folder\ansible\modules\pip.py,566.0
ansible.modules.replace.check_file_attrs,216,3,2,1,2,0,0,11.0,3.0,0.0,D:\BaiduNetdiskDownload\graduation_project\project_folder\ansible\modules\replace.py,216.0
ansible.modules.replace.main,229,11,10,1,10,0,0,92.0,1.0,0.0,D:\BaiduNetdiskDownload\graduation_project\project_folder\ansible\modules\replace.py,229.0
ansible.modules.replace.write_changes,195,5,4,1,4,0,0,19.0,3.0,0.0,D:\BaiduNetdiskDownload\graduation_project\project_folder\ansible\modules\replace.py,195.0
ansible.modules.rpm_key.RpmKey.__init__,98,13,12,1,12,0,0,52.0,2.0,0.0,D:\BaiduNetdiskDownload\graduation_project\project_folder\ansible\modules\rpm_key.py,98.0
ansible.modules.rpm_key.RpmKey.drop_key,232,3,2,1,2,0,0,3.0,2.0,0.0,D:\BaiduNetdiskDownload\graduation_project\project_folder\ansible\modules\rpm_key.py,232.0
ansible.modules.rpm_key.RpmKey.execute_command,210,7,2,5,2,0,0,5.0,2.0,0.0,D:\BaiduNetdiskDownload\graduation_project\project_folder\ansible\modules\rpm_key.py,210.0
ansible.modules.rpm_key.RpmKey.fetch_key,151,7,6,1,6,0,0,15.0,2.0,0.0,D:\BaiduNetdiskDownload\graduation_project\project_folder\ansible\modules\rpm_key.py,151.0
ansible.modules.rpm_key.RpmKey.getfingerprint,186,7,6,1,6,0,0,19.0,2.0,0.0,D:\BaiduNetdiskDownload\graduation_project\project_folder\ansible\modules\rpm_key.py,186.0
ansible.modules.rpm_key.RpmKey.getkeyid,177,7,6,1,6,0,0,8.0,2.0,0.0,D:\BaiduNetdiskDownload\graduation_project\project_folder\ansible\modules\rpm_key.py,177.0
ansible.modules.rpm_key.RpmKey.import_key,228,2,1,1,1,0,0,3.0,2.0,0.0,D:\BaiduNetdiskDownload\graduation_project\project_folder\ansible\modules\rpm_key.py,228.0
ansible.modules.rpm_key.RpmKey.is_key_imported,216,5,4,1,4,0,0,11.0,2.0,0.0,D:\BaiduNetdiskDownload\graduation_project\project_folder\ansible\modules\rpm_key.py,216.0
ansible.modules.rpm_key.RpmKey.is_keyid,206,1,0,1,0,0,0,3.0,2.0,0.0,D:\BaiduNetdiskDownload\graduation_project\project_folder\ansible\modules\rpm_key.py,206.0
ansible.modules.rpm_key.RpmKey.normalize_keyid,167,4,3,1,3,0,0,9.0,2.0,0.0,D:\BaiduNetdiskDownload\graduation_project\project_folder\ansible\modules\rpm_key.py,167.0
ansible.modules.rpm_key.is_pubkey,90,1,0,1,0,0,0,4.0,1.0,0.0,D:\BaiduNetdiskDownload\graduation_project\project_folder\ansible\modules\rpm_key.py,90.0
ansible.modules.rpm_key.main,237,3,2,1,2,0,0,12.0,1.0,0.0,D:\BaiduNetdiskDownload\graduation_project\project_folder\ansible\modules\rpm_key.py,237.0
ansible.modules.service.AIX.get_aix_src_status,1438,7,6,1,6,0,0,31.0,1.0,0.0,D:\BaiduNetdiskDownload\graduation_project\project_folder\ansible\modules\service.py,1438.0
ansible.modules.service.AIX.get_service_status,1429,1,1,0,1,0,0,8.0,1.0,0.0,D:\BaiduNetdiskDownload\graduation_project\project_folder\ansible\modules\service.py,1429.0
ansible.modules.service.AIX.get_service_tools,1408,1,1,0,1,0,0,20.0,1.0,0.0,D:\BaiduNetdiskDownload\graduation_project\project_folder\ansible\modules\service.py,1408.0
ansible.modules.service.AIX.service_control,1470,6,6,0,6,0,0,43.0,1.0,0.0,D:\BaiduNetdiskDownload\graduation_project\project_folder\ansible\modules\service.py,1470.0
ansible.modules.service.DragonFlyBsdService.service_enable,1118,2,2,0,2,0,0,14.0,1.0,0.0,D:\BaiduNetdiskDownload\graduation_project\project_folder\ansible\modules\service.py,1118.0
ansible.modules.service.FreeBsdService.get_service_status,1014,1,1,0,1,0,0,9.0,1.0,0.0,D:\BaiduNetdiskDownload\graduation_project\project_folder\ansible\modules\service.py,1014.0
ansible.modules.service.FreeBsdService.get_service_tools,1007,1,1,0,1,0,0,6.0,1.0,0.0,D:\BaiduNetdiskDownload\graduation_project\project_folder\ansible\modules\service.py,1007.0
ansible.modules.service.FreeBsdService.service_control,1091,1,1,0,1,0,0,15.0,1.0,0.0,D:\BaiduNetdiskDownload\graduation_project\project_folder\ansible\modules\service.py,1091.0
ansible.modules.service.FreeBsdService.service_enable,1024,7,7,0,7,0,0,66.0,1.0,0.0,D:\BaiduNetdiskDownload\graduation_project\project_folder\ansible\modules\service.py,1024.0
ansible.modules.service.LinuxService.get_service_status,623,6,6,0,6,0,0,61.0,1.0,0.0,D:\BaiduNetdiskDownload\graduation_project\project_folder\ansible\modules\service.py,623.0
ansible.modules.service.LinuxService.get_service_tools,468,7,7,0,7,0,0,77.0,1.0,2.0,D:\BaiduNetdiskDownload\graduation_project\project_folder\ansible\modules\service.py,468.0
ansible.modules.service.LinuxService.get_systemd_service_enabled,546,5,4,1,4,0,0,18.0,1.0,2.0,D:\BaiduNetdiskDownload\graduation_project\project_folder\ansible\modules\service.py,546.0
ansible.modules.service.LinuxService.get_systemd_service_status,605,3,2,1,2,0,0,17.0,1.0,0.0,D:\BaiduNetdiskDownload\graduation_project\project_folder\ansible\modules\service.py,605.0
ansible.modules.service.LinuxService.get_systemd_status_dict,565,11,10,1,10,0,0,39.0,1.0,0.0,D:\BaiduNetdiskDownload\graduation_project\project_folder\ansible\modules\service.py,565.0
ansible.modules.service.LinuxService.service_control,928,3,2,1,2,0,0,67.0,1.0,0.0,D:\BaiduNetdiskDownload\graduation_project\project_folder\ansible\modules\service.py,928.0
ansible.modules.service.LinuxService.service_enable,685,14,14,0,14,0,0,242.0,1.0,0.0,D:\BaiduNetdiskDownload\graduation_project\project_folder\ansible\modules\service.py,685.0
ansible.modules.service.NetBsdService.get_service_status,1245,1,1,0,1,0,0,7.0,1.0,0.0,D:\BaiduNetdiskDownload\graduation_project\project_folder\ansible\modules\service.py,1245.0
ansible.modules.service.NetBsdService.get_service_tools,1219,1,1,0,1,0,0,10.0,1.0,0.0,D:\BaiduNetdiskDownload\graduation_project\project_folder\ansible\modules\service.py,1219.0
ansible.modules.service.NetBsdService.service_control,1253,1,1,0,1,0,0,8.0,1.0,0.0,D:\BaiduNetdiskDownload\graduation_project\project_folder\ansible\modules\service.py,1253.0
ansible.modules.service.NetBsdService.service_enable,1230,2,2,0,2,0,0,14.0,1.0,0.0,D:\BaiduNetdiskDownload\graduation_project\project_folder\ansible\modules\service.py,1230.0
ansible.modules.service.OpenBsdService.get_service_status,1159,2,2,0,2,0,0,13.0,1.0,0.0,D:\BaiduNetdiskDownload\graduation_project\project_folder\ansible\modules\service.py,1159.0
ansible.modules.service.OpenBsdService.get_service_tools,1144,1,1,0,1,0,0,14.0,1.0,0.0,D:\BaiduNetdiskDownload\graduation_project\project_folder\ansible\modules\service.py,1144.0
ansible.modules.service.OpenBsdService.service_control,1173,1,1,0,1,0,0,5.0,1.0,0.0,D:\BaiduNetdiskDownload\graduation_project\project_folder\ansible\modules\service.py,1173.0
ansible.modules.service.OpenBsdService.service_enable,1179,2,2,0,2,0,0,26.0,1.0,0.0,D:\BaiduNetdiskDownload\graduation_project\project_folder\ansible\modules\service.py,1179.0
ansible.modules.service.Service.__new__,203,2,1,1,1,0,0,3.0,3.0,0.0,D:\BaiduNetdiskDownload\graduation_project\project_folder\ansible\modules\service.py,203.0
ansible.modules.service.Service.check_ps,341,3,2,1,2,0,0,20.0,1.0,0.0,D:\BaiduNetdiskDownload\graduation_project\project_folder\ansible\modules\service.py,341.0
ansible.modules.service.Service.check_service_changed,362,3,2,1,2,0,0,12.0,1.0,0.0,D:\BaiduNetdiskDownload\graduation_project\project_folder\ansible\modules\service.py,362.0
ansible.modules.service.Service.execute_command,247,26,7,19,7,0,0,93.0,2.0,0.0,D:\BaiduNetdiskDownload\graduation_project\project_folder\ansible\modules\service.py,247.0
ansible.modules.service.Service.get_service_status,238,2,1,1,1,0,0,2.0,1.0,0.0,D:\BaiduNetdiskDownload\graduation_project\project_folder\ansible\modules\service.py,238.0
ansible.modules.service.Service.get_service_tools,232,2,1,1,1,0,0,2.0,1.0,0.0,D:\BaiduNetdiskDownload\graduation_project\project_folder\ansible\modules\service.py,232.0
ansible.modules.service.Service.modify_service_state,375,3,2,1,2,0,0,27.0,1.0,0.0,D:\BaiduNetdiskDownload\graduation_project\project_folder\ansible\modules\service.py,375.0
ansible.modules.service.Service.service_control,241,2,1,1,1,0,0,2.0,1.0,0.0,D:\BaiduNetdiskDownload\graduation_project\project_folder\ansible\modules\service.py,241.0
ansible.modules.service.Service.service_enable,235,2,1,1,1,0,0,2.0,1.0,0.0,D:\BaiduNetdiskDownload\graduation_project\project_folder\ansible\modules\service.py,235.0
ansible.modules.service.Service.service_enable_rcconf,403,10,7,3,7,0,0,53.0,1.0,0.0,D:\BaiduNetdiskDownload\graduation_project\project_folder\ansible\modules\service.py,403.0
ansible.modules.service.SunOSService.get_service_status,1297,1,1,0,1,0,0,8.0,1.0,0.0,D:\BaiduNetdiskDownload\graduation_project\project_folder\ansible\modules\service.py,1297.0
ansible.modules.service.SunOSService.get_service_tools,1273,2,2,0,2,0,0,15.0,1.0,0.0,D:\BaiduNetdiskDownload\graduation_project\project_folder\ansible\modules\service.py,1273.0
ansible.modules.service.SunOSService.get_sunos_svcs_status,1306,6,4,2,4,0,0,13.0,1.0,0.0,D:\BaiduNetdiskDownload\graduation_project\project_folder\ansible\modules\service.py,1306.0
ansible.modules.service.SunOSService.service_control,1370,3,3,0,3,0,0,25.0,1.0,0.0,D:\BaiduNetdiskDownload\graduation_project\project_folder\ansible\modules\service.py,1370.0
ansible.modules.service.SunOSService.service_enable,1320,4,4,0,4,0,0,49.0,1.0,0.0,D:\BaiduNetdiskDownload\graduation_project\project_folder\ansible\modules\service.py,1320.0
ansible.modules.service.SunOSService.svcadm_supports_sync,1289,3,2,1,2,0,0,7.0,1.0,0.0,D:\BaiduNetdiskDownload\graduation_project\project_folder\ansible\modules\service.py,1289.0
ansible.modules.service.main,1518,12,11,1,11,0,0,89.0,1.0,0.0,D:\BaiduNetdiskDownload\graduation_project\project_folder\ansible\modules\service.py,1518.0
ansible.modules.service_facts.AIXScanService.gather_services,314,2,2,0,2,0,0,25.0,1.0,0.0,D:\BaiduNetdiskDownload\graduation_project\project_folder\ansible\modules\service_facts.py,314.0
ansible.modules.service_facts.OpenBSDScanService.gather_services,371,2,2,0,2,0,0,34.0,1.0,0.0,D:\BaiduNetdiskDownload\graduation_project\project_folder\ansible\modules\service_facts.py,371.0
ansible.modules.service_facts.OpenBSDScanService.get_info,356,5,4,1,4,0,0,14.0,2.0,0.0,D:\BaiduNetdiskDownload\graduation_project\project_folder\ansible\modules\service_facts.py,356.0
ansible.modules.service_facts.OpenBSDScanService.query_rcctl,343,5,4,1,4,0,0,12.0,2.0,0.0,D:\BaiduNetdiskDownload\graduation_project\project_folder\ansible\modules\service_facts.py,343.0
ansible.modules.service_facts.ServiceScanService._list_openrc,197,4,3,1,3,0,0,23.0,2.0,0.0,D:\BaiduNetdiskDownload\graduation_project\project_folder\ansible\modules\service_facts.py,197.0
ansible.modules.service_facts.ServiceScanService._list_rh,148,5,4,1,4,0,0,48.0,2.0,0.0,D:\BaiduNetdiskDownload\graduation_project\project_folder\ansible\modules\service_facts.py,148.0
ansible.modules.service_facts.ServiceScanService._list_sysvinit,108,2,1,1,1,0,0,18.0,2.0,0.0,D:\BaiduNetdiskDownload\graduation_project\project_folder\ansible\modules\service_facts.py,108.0
ansible.modules.service_facts.ServiceScanService._list_upstart,127,5,4,1,4,0,0,20.0,2.0,0.0,D:\BaiduNetdiskDownload\graduation_project\project_folder\ansible\modules\service_facts.py,127.0
ansible.modules.service_facts.ServiceScanService.gather_services,221,4,4,0,4,0,0,20.0,1.0,0.0,D:\BaiduNetdiskDownload\graduation_project\project_folder\ansible\modules\service_facts.py,221.0
ansible.modules.service_facts.SystemctlScanService._list_from_unit_files,278,7,6,1,6,0,0,21.0,3.0,0.0,D:\BaiduNetdiskDownload\graduation_project\project_folder\ansible\modules\service_facts.py,278.0
ansible.modules.service_facts.SystemctlScanService._list_from_units,250,3,2,1,2,0,0,27.0,3.0,0.0,D:\BaiduNetdiskDownload\graduation_project\project_folder\ansible\modules\service_facts.py,250.0
ansible.modules.service_facts.SystemctlScanService.gather_services,300,3,3,0,3,0,0,10.0,1.0,0.0,D:\BaiduNetdiskDownload\graduation_project\project_folder\ansible\modules\service_facts.py,300.0
ansible.modules.service_facts.SystemctlScanService.systemd_enabled,247,2,1,1,1,0,0,2.0,1.0,0.0,D:\BaiduNetdiskDownload\graduation_project\project_folder\ansible\modules\service_facts.py,247.0
ansible.modules.service_facts.main,407,4,3,1,3,0,0,16.0,1.0,0.0,D:\BaiduNetdiskDownload\graduation_project\project_folder\ansible\modules\service_facts.py,407.0
ansible.modules.setup.main,182,6,5,1,5,0,0,44.0,1.0,0.0,D:\BaiduNetdiskDownload\graduation_project\project_folder\ansible\modules\setup.py,182.0
ansible.modules.slurp.main,91,5,4,1,4,0,0,27.0,1.0,0.0,D:\BaiduNetdiskDownload\graduation_project\project_folder\ansible\modules\slurp.py,91.0
ansible.modules.stat.format_output,382,1,0,1,0,0,0,60.0,3.0,0.0,D:\BaiduNetdiskDownload\graduation_project\project_folder\ansible\modules\stat.py,382.0
ansible.modules.stat.main,444,13,12,1,12,0,0,91.0,1.0,0.0,D:\BaiduNetdiskDownload\graduation_project\project_folder\ansible\modules\stat.py,444.0
ansible.modules.subversion.Subversion.__init__,149,1,0,1,0,0,0,9.0,9.0,0.0,D:\BaiduNetdiskDownload\graduation_project\project_folder\ansible\modules\subversion.py,149.0
ansible.modules.subversion.Subversion._exec,163,15,5,10,5,0,0,27.0,2.0,0.0,D:\BaiduNetdiskDownload\graduation_project\project_folder\ansible\modules\subversion.py,163.0
ansible.modules.subversion.Subversion.checkout,196,4,3,1,3,0,0,7.0,1.0,0.0,D:\BaiduNetdiskDownload\graduation_project\project_folder\ansible\modules\subversion.py,196.0
ansible.modules.subversion.Subversion.export,204,4,3,1,3,0,0,8.0,1.0,0.0,D:\BaiduNetdiskDownload\graduation_project\project_folder\ansible\modules\subversion.py,204.0
ansible.modules.subversion.Subversion.get_remote_revision,257,3,2,1,2,0,0,9.0,1.0,0.0,D:\BaiduNetdiskDownload\graduation_project\project_folder\ansible\modules\subversion.py,257.0
ansible.modules.subversion.Subversion.get_revision,240,4,2,2,2,0,0,16.0,1.0,0.0,D:\BaiduNetdiskDownload\graduation_project\project_folder\ansible\modules\subversion.py,240.0
ansible.modules.subversion.Subversion.has_local_mods,267,2,1,1,1,0,0,8.0,1.0,0.0,D:\BaiduNetdiskDownload\graduation_project\project_folder\ansible\modules\subversion.py,267.0
ansible.modules.subversion.Subversion.has_option_password_from_stdin,159,3,2,1,2,0,0,3.0,1.0,0.0,D:\BaiduNetdiskDownload\graduation_project\project_folder\ansible\modules\subversion.py,159.0
ansible.modules.subversion.Subversion.is_svn_repo,191,2,1,1,1,0,0,4.0,1.0,0.0,D:\BaiduNetdiskDownload\graduation_project\project_folder\ansible\modules\subversion.py,191.0
ansible.modules.subversion.Subversion.needs_update,276,6,5,1,5,0,0,14.0,1.0,0.0,D:\BaiduNetdiskDownload\graduation_project\project_folder\ansible\modules\subversion.py,276.0
ansible.modules.subversion.Subversion.revert,232,2,1,1,1,0,0,7.0,1.0,0.0,D:\BaiduNetdiskDownload\graduation_project\project_folder\ansible\modules\subversion.py,232.0
ansible.modules.subversion.Subversion.switch,213,2,1,1,1,0,0,9.0,1.0,0.0,D:\BaiduNetdiskDownload\graduation_project\project_folder\ansible\modules\subversion.py,213.0
ansible.modules.subversion.Subversion.update,223,2,1,1,1,0,0,8.0,1.0,0.0,D:\BaiduNetdiskDownload\graduation_project\project_folder\ansible\modules\subversion.py,223.0
ansible.modules.subversion.main,292,17,16,1,16,0,0,97.0,1.0,0.0,D:\BaiduNetdiskDownload\graduation_project\project_folder\ansible\modules\subversion.py,292.0
ansible.modules.systemd_service.is_deactivating_service,296,1,0,1,0,0,0,2.0,1.0,0.0,D:\BaiduNetdiskDownload\graduation_project\project_folder\ansible\modules\systemd_service.py,296.0
ansible.modules.systemd_service.is_running_service,292,1,0,1,0,0,0,2.0,1.0,0.0,D:\BaiduNetdiskDownload\graduation_project\project_folder\ansible\modules\systemd_service.py,292.0
ansible.modules.systemd_service.main,342,21,20,1,20,0,0,242.0,1.0,0.0,D:\BaiduNetdiskDownload\graduation_project\project_folder\ansible\modules\systemd_service.py,342.0
ansible.modules.systemd_service.parse_systemctl_show,304,9,8,1,8,0,0,33.0,1.0,0.0,D:\BaiduNetdiskDownload\graduation_project\project_folder\ansible\modules\systemd_service.py,304.0
ansible.modules.systemd_service.request_was_ignored,300,1,0,1,0,0,0,2.0,1.0,0.0,D:\BaiduNetdiskDownload\graduation_project\project_folder\ansible\modules\systemd_service.py,300.0
ansible.modules.sysvinit.main,142,16,15,1,15,0,0,229.0,1.0,0.0,D:\BaiduNetdiskDownload\graduation_project\project_folder\ansible\modules\sysvinit.py,142.0
ansible.modules.tempfile.main,99,4,3,1,3,0,0,28.0,1.0,0.0,D:\BaiduNetdiskDownload\graduation_project\project_folder\ansible\modules\tempfile.py,99.0
ansible.modules.unarchive.TgzArchive.__init__,763,2,2,0,2,0,0,14.0,5.0,0.0,D:\BaiduNetdiskDownload\graduation_project\project_folder\ansible\modules\unarchive.py,763.0
ansible.modules.unarchive.TgzArchive._get_tar_type,778,3,2,1,2,0,0,9.0,1.0,0.0,D:\BaiduNetdiskDownload\graduation_project\project_folder\ansible\modules\unarchive.py,778.0
ansible.modules.unarchive.TgzArchive.can_handle_archive,910,2,2,0,2,0,0,24.0,1.0,0.0,D:\BaiduNetdiskDownload\graduation_project\project_folder\ansible\modules\unarchive.py,910.0
ansible.modules.unarchive.TgzArchive.files_in_archive,789,6,6,0,6,0,0,43.0,1.0,0.0,D:\BaiduNetdiskDownload\graduation_project\project_folder\ansible\modules\unarchive.py,789.0
ansible.modules.unarchive.TgzArchive.is_unarchived,833,7,7,0,7,0,0,55.0,1.0,0.0,D:\BaiduNetdiskDownload\graduation_project\project_folder\ansible\modules\unarchive.py,833.0
ansible.modules.unarchive.TgzArchive.unarchive,889,5,5,0,5,0,0,20.0,1.0,0.0,D:\BaiduNetdiskDownload\graduation_project\project_folder\ansible\modules\unarchive.py,889.0
ansible.modules.unarchive.ZipArchive._crc32,346,4,3,1,3,0,0,22.0,2.0,0.0,D:\BaiduNetdiskDownload\graduation_project\project_folder\ansible\modules\unarchive.py,346.0
ansible.modules.unarchive.ZipArchive._legacy_file_list,335,6,4,2,4,0,0,10.0,1.0,0.0,D:\BaiduNetdiskDownload\graduation_project\project_folder\ansible\modules\unarchive.py,335.0
ansible.modules.unarchive.ZipArchive._permstr_to_octal,322,1,0,1,0,0,0,12.0,3.0,0.0,D:\BaiduNetdiskDownload\graduation_project\project_folder\ansible\modules\unarchive.py,322.0
ansible.modules.unarchive.ZipArchive.can_handle_archive,740,5,5,0,5,0,0,19.0,1.0,0.0,D:\BaiduNetdiskDownload\graduation_project\project_folder\ansible\modules\unarchive.py,740.0
ansible.modules.unarchive.ZipArchive.files_in_archive,370,4,4,0,4,0,0,36.0,1.0,0.0,D:\BaiduNetdiskDownload\graduation_project\project_folder\ansible\modules\unarchive.py,370.0
ansible.modules.unarchive.ZipArchive.is_unarchived,407,16,16,0,16,0,0,315.0,1.0,0.0,D:\BaiduNetdiskDownload\graduation_project\project_folder\ansible\modules\unarchive.py,407.0
ansible.modules.unarchive.ZipArchive.unarchive,723,3,3,0,3,0,0,16.0,1.0,0.0,D:\BaiduNetdiskDownload\graduation_project\project_folder\ansible\modules\unarchive.py,723.0
ansible.modules.unarchive.ZipZArchive.can_handle_archive,981,2,2,0,2,0,0,12.0,1.0,0.0,D:\BaiduNetdiskDownload\graduation_project\project_folder\ansible\modules\unarchive.py,981.0
ansible.modules.unarchive.crc32,281,1,0,1,0,0,0,8.0,2.0,0.0,D:\BaiduNetdiskDownload\graduation_project\project_folder\ansible\modules\unarchive.py,281.0
ansible.modules.unarchive.main,1009,13,12,1,12,0,0,125.0,1.0,0.0,D:\BaiduNetdiskDownload\graduation_project\project_folder\ansible\modules\unarchive.py,1009.0
ansible.modules.unarchive.pick_handler,996,4,3,1,3,0,0,11.0,4.0,0.0,D:\BaiduNetdiskDownload\graduation_project\project_folder\ansible\modules\unarchive.py,996.0
ansible.modules.uri.absolute_location,508,3,2,1,2,0,0,19.0,2.0,0.0,D:\BaiduNetdiskDownload\graduation_project\project_folder\ansible\modules\uri.py,508.0
ansible.modules.uri.form_urlencoded,543,4,3,1,3,0,0,17.0,1.0,0.0,D:\BaiduNetdiskDownload\graduation_project\project_folder\ansible\modules\uri.py,543.0
ansible.modules.uri.format_message,467,2,1,1,1,0,0,3.0,2.0,0.0,D:\BaiduNetdiskDownload\graduation_project\project_folder\ansible\modules\uri.py,467.0
ansible.modules.uri.kv_list,529,2,1,1,1,0,0,12.0,1.0,0.0,D:\BaiduNetdiskDownload\graduation_project\project_folder\ansible\modules\uri.py,529.0
ansible.modules.uri.main,606,24,23,1,23,0,0,190.0,1.0,0.0,D:\BaiduNetdiskDownload\graduation_project\project_folder\ansible\modules\uri.py,606.0
ansible.modules.uri.uri,562,4,3,1,3,0,0,42.0,13.0,0.0,D:\BaiduNetdiskDownload\graduation_project\project_folder\ansible\modules\uri.py,562.0
ansible.modules.uri.write_file,472,6,5,1,5,0,0,34.0,4.0,0.0,D:\BaiduNetdiskDownload\graduation_project\project_folder\ansible\modules\uri.py,472.0
ansible.modules.user.AIX.create_user_useradd,2636,6,6,0,6,0,0,53.0,1.0,0.0,D:\BaiduNetdiskDownload\graduation_project\project_folder\ansible\modules\user.py,2636.0
ansible.modules.user.AIX.modify_user_usermod,2690,10,10,0,10,0,0,76.0,1.0,0.0,D:\BaiduNetdiskDownload\graduation_project\project_folder\ansible\modules\user.py,2690.0
ansible.modules.user.AIX.parse_shadow_file,2767,5,5,0,5,0,0,45.0,1.0,0.0,D:\BaiduNetdiskDownload\graduation_project\project_folder\ansible\modules\user.py,2767.0
ansible.modules.user.AIX.remove_user,2628,2,2,0,2,0,0,7.0,1.0,0.0,D:\BaiduNetdiskDownload\graduation_project\project_folder\ansible\modules\user.py,2628.0
ansible.modules.user.BusyBox.create_user,2968,6,6,0,6,0,0,68.0,1.0,0.0,D:\BaiduNetdiskDownload\graduation_project\project_folder\ansible\modules\user.py,2968.0
ansible.modules.user.BusyBox.modify_user,3049,8,8,0,8,0,0,41.0,1.0,0.0,D:\BaiduNetdiskDownload\graduation_project\project_folder\ansible\modules\user.py,3049.0
ansible.modules.user.BusyBox.remove_user,3037,2,2,0,2,0,0,11.0,1.0,0.0,D:\BaiduNetdiskDownload\graduation_project\project_folder\ansible\modules\user.py,3037.0
ansible.modules.user.DarwinUser.__init__,2285,1,1,0,1,0,0,16.0,2.0,0.0,D:\BaiduNetdiskDownload\graduation_project\project_folder\ansible\modules\user.py,2285.0
ansible.modules.user.DarwinUser.__modify_group,2398,3,2,1,2,0,0,13.0,3.0,0.0,D:\BaiduNetdiskDownload\graduation_project\project_folder\ansible\modules\user.py,2398.0
ansible.modules.user.DarwinUser._change_user_password,2365,5,3,2,3,0,0,21.0,1.0,0.0,D:\BaiduNetdiskDownload\graduation_project\project_folder\ansible\modules\user.py,2365.0
ansible.modules.user.DarwinUser._get_dscl,2302,8,0,8,0,0,0,2.0,1.0,0.0,D:\BaiduNetdiskDownload\graduation_project\project_folder\ansible\modules\user.py,2302.0
ansible.modules.user.DarwinUser._get_next_uid,2336,6,5,1,5,0,0,28.0,1.0,0.0,D:\BaiduNetdiskDownload\graduation_project\project_folder\ansible\modules\user.py,2336.0
ansible.modules.user.DarwinUser._get_user_property,2316,7,6,1,6,0,0,19.0,2.0,0.0,D:\BaiduNetdiskDownload\graduation_project\project_folder\ansible\modules\user.py,2316.0
ansible.modules.user.DarwinUser._list_user_groups,2305,7,6,1,6,0,0,10.0,1.0,0.0,D:\BaiduNetdiskDownload\graduation_project\project_folder\ansible\modules\user.py,2305.0
ansible.modules.user.DarwinUser._make_group_numerical,2387,3,1,2,1,0,0,10.0,1.0,0.0,D:\BaiduNetdiskDownload\graduation_project\project_folder\ansible\modules\user.py,2387.0
ansible.modules.user.DarwinUser._modify_group,2412,5,3,2,3,0,0,31.0,1.0,0.0,D:\BaiduNetdiskDownload\graduation_project\project_folder\ansible\modules\user.py,2412.0
ansible.modules.user.DarwinUser._update_system_user,2444,9,7,2,7,0,0,40.0,1.0,0.0,D:\BaiduNetdiskDownload\graduation_project\project_folder\ansible\modules\user.py,2444.0
ansible.modules.user.DarwinUser.create_user,2510,9,9,0,9,0,0,59.0,1.0,0.0,D:\BaiduNetdiskDownload\graduation_project\project_folder\ansible\modules\user.py,2510.0
ansible.modules.user.DarwinUser.modify_user,2570,9,9,0,9,0,0,41.0,1.0,0.0,D:\BaiduNetdiskDownload\graduation_project\project_folder\ansible\modules\user.py,2570.0
ansible.modules.user.DarwinUser.remove_user,2492,4,4,0,4,0,0,17.0,1.0,0.0,D:\BaiduNetdiskDownload\graduation_project\project_folder\ansible\modules\user.py,2492.0
ansible.modules.user.DarwinUser.user_exists,2485,2,2,0,2,0,0,6.0,1.0,0.0,D:\BaiduNetdiskDownload\graduation_project\project_folder\ansible\modules\user.py,2485.0
ansible.modules.user.FreeBsdUser._handle_lock,1350,6,4,2,4,0,0,24.0,1.0,0.0,D:\BaiduNetdiskDownload\graduation_project\project_folder\ansible\modules\user.py,1350.0
ansible.modules.user.FreeBsdUser.create_user,1387,7,7,0,7,0,0,89.0,1.0,0.0,D:\BaiduNetdiskDownload\graduation_project\project_folder\ansible\modules\user.py,1387.0
ansible.modules.user.FreeBsdUser.modify_user,1477,15,15,0,15,0,0,138.0,1.0,0.0,D:\BaiduNetdiskDownload\graduation_project\project_folder\ansible\modules\user.py,1477.0
ansible.modules.user.FreeBsdUser.remove_user,1375,2,2,0,2,0,0,11.0,1.0,0.0,D:\BaiduNetdiskDownload\graduation_project\project_folder\ansible\modules\user.py,1375.0
ansible.modules.user.HPUX.create_user,2828,6,6,0,6,0,0,47.0,1.0,0.0,D:\BaiduNetdiskDownload\graduation_project\project_folder\ansible\modules\user.py,2828.0
ansible.modules.user.HPUX.modify_user,2885,10,10,0,10,0,0,72.0,1.0,0.0,D:\BaiduNetdiskDownload\graduation_project\project_folder\ansible\modules\user.py,2885.0
ansible.modules.user.HPUX.remove_user,2876,2,2,0,2,0,0,8.0,1.0,0.0,D:\BaiduNetdiskDownload\graduation_project\project_folder\ansible\modules\user.py,2876.0
ansible.modules.user.NetBSDUser.create_user,1820,6,6,0,6,0,0,56.0,1.0,0.0,D:\BaiduNetdiskDownload\graduation_project\project_folder\ansible\modules\user.py,1820.0
ansible.modules.user.NetBSDUser.modify_user,1884,11,11,0,11,0,0,80.0,1.0,0.0,D:\BaiduNetdiskDownload\graduation_project\project_folder\ansible\modules\user.py,1884.0
ansible.modules.user.NetBSDUser.remove_user_userdel,1877,2,2,0,2,0,0,6.0,1.0,0.0,D:\BaiduNetdiskDownload\graduation_project\project_folder\ansible\modules\user.py,1877.0
ansible.modules.user.OpenBSDUser.create_user,1645,6,6,0,6,0,0,54.0,1.0,0.0,D:\BaiduNetdiskDownload\graduation_project\project_folder\ansible\modules\user.py,1645.0
ansible.modules.user.OpenBSDUser.modify_user,1707,13,13,0,13,0,0,93.0,1.0,0.0,D:\BaiduNetdiskDownload\graduation_project\project_folder\ansible\modules\user.py,1707.0
ansible.modules.user.OpenBSDUser.remove_user_userdel,1700,2,2,0,2,0,0,6.0,1.0,0.0,D:\BaiduNetdiskDownload\graduation_project\project_folder\ansible\modules\user.py,1700.0
ansible.modules.user.SunOS._user_attr_info,2240,3,2,1,2,0,0,11.0,1.0,0.0,D:\BaiduNetdiskDownload\graduation_project\project_folder\ansible\modules\user.py,2240.0
ansible.modules.user.SunOS.create_user,2019,10,10,0,10,0,0,104.0,1.0,0.0,D:\BaiduNetdiskDownload\graduation_project\project_folder\ansible\modules\user.py,2019.0
ansible.modules.user.SunOS.get_password_defaults,1985,7,5,2,5,0,0,25.0,1.0,0.0,D:\BaiduNetdiskDownload\graduation_project\project_folder\ansible\modules\user.py,1985.0
ansible.modules.user.SunOS.modify_user_usermod,2124,14,14,0,14,0,0,109.0,1.0,0.0,D:\BaiduNetdiskDownload\graduation_project\project_folder\ansible\modules\user.py,2124.0
ansible.modules.user.SunOS.remove_user,2011,2,2,0,2,0,0,7.0,1.0,0.0,D:\BaiduNetdiskDownload\graduation_project\project_folder\ansible\modules\user.py,2011.0
ansible.modules.user.SunOS.user_info,2234,2,1,1,1,0,0,5.0,1.0,0.0,D:\BaiduNetdiskDownload\graduation_project\project_folder\ansible\modules\user.py,2234.0
ansible.modules.user.User.__init__,547,2,2,0,2,0,0,61.0,2.0,0.0,D:\BaiduNetdiskDownload\graduation_project\project_folder\ansible\modules\user.py,547.0
ansible.modules.user.User.__new__,543,2,1,1,1,0,0,3.0,3.0,0.0,D:\BaiduNetdiskDownload\graduation_project\project_folder\ansible\modules\user.py,543.0
ansible.modules.user.User._check_usermod_append,812,5,4,1,4,0,0,26.0,1.0,0.0,D:\BaiduNetdiskDownload\graduation_project\project_folder\ansible\modules\user.py,812.0
ansible.modules.user.User.backup_shadow,657,3,1,2,1,0,0,3.0,1.0,0.0,D:\BaiduNetdiskDownload\graduation_project\project_folder\ansible\modules\user.py,657.0
ansible.modules.user.User.check_password_encrypted,609,3,2,1,2,0,0,38.0,1.0,0.0,D:\BaiduNetdiskDownload\graduation_project\project_folder\ansible\modules\user.py,609.0
ansible.modules.user.User.chown_homedir,1318,3,1,2,1,0,0,10.0,4.0,0.0,D:\BaiduNetdiskDownload\graduation_project\project_folder\ansible\modules\user.py,1318.0
ansible.modules.user.User.create_homedir,1288,3,1,2,1,0,0,29.0,2.0,0.0,D:\BaiduNetdiskDownload\graduation_project\project_folder\ansible\modules\user.py,1288.0
ansible.modules.user.User.create_user,1276,2,1,1,1,0,0,135.0,1.0,0.0,D:\BaiduNetdiskDownload\graduation_project\project_folder\ansible\modules\user.py,676.0
ansible.modules.user.User.create_user_useradd,676,9,8,1,8,0,0,135.0,1.0,0.0,D:\BaiduNetdiskDownload\graduation_project\project_folder\ansible\modules\user.py,676.0
ansible.modules.user.User.execute_command,648,40,1,39,1,0,0,8.0,2.0,0.0,D:\BaiduNetdiskDownload\graduation_project\project_folder\ansible\modules\user.py,648.0
ansible.modules.user.User.get_groups_set,1022,24,7,17,7,0,0,17.0,1.0,0.0,D:\BaiduNetdiskDownload\graduation_project\project_folder\ansible\modules\user.py,1022.0
ansible.modules.user.User.get_pwd_info,1082,3,1,2,1,0,0,4.0,1.0,0.0,D:\BaiduNetdiskDownload\graduation_project\project_folder\ansible\modules\user.py,1082.0
ansible.modules.user.User.get_ssh_key_path,1155,5,1,4,1,0,0,9.0,1.0,0.0,D:\BaiduNetdiskDownload\graduation_project\project_folder\ansible\modules\user.py,1155.0
ansible.modules.user.User.get_ssh_public_key,1267,4,3,1,3,0,0,8.0,1.0,0.0,D:\BaiduNetdiskDownload\graduation_project\project_folder\ansible\modules\user.py,1267.0
ansible.modules.user.User.group_exists,1001,17,0,17,0,0,0,11.0,2.0,0.0,D:\BaiduNetdiskDownload\graduation_project\project_folder\ansible\modules\user.py,1001.0
ansible.modules.user.User.group_info,1013,9,1,8,1,0,0,8.0,2.0,0.0,D:\BaiduNetdiskDownload\graduation_project\project_folder\ansible\modules\user.py,1013.0
ansible.modules.user.User.modify_user,1284,2,1,1,1,0,0,161.0,1.0,0.0,D:\BaiduNetdiskDownload\graduation_project\project_folder\ansible\modules\user.py,839.0
ansible.modules.user.User.modify_user_usermod,839,15,14,1,14,0,0,161.0,1.0,0.0,D:\BaiduNetdiskDownload\graduation_project\project_folder\ansible\modules\user.py,839.0
ansible.modules.user.User.parse_shadow_file,1144,3,2,1,2,0,0,10.0,1.0,0.0,D:\BaiduNetdiskDownload\graduation_project\project_folder\ansible\modules\user.py,1144.0
ansible.modules.user.User.remove_user,1280,2,1,1,1,0,0,14.0,1.0,0.0,D:\BaiduNetdiskDownload\graduation_project\project_folder\ansible\modules\user.py,661.0
ansible.modules.user.User.remove_user_userdel,661,3,2,1,2,0,0,14.0,1.0,0.0,D:\BaiduNetdiskDownload\graduation_project\project_folder\ansible\modules\user.py,661.0
ansible.modules.user.User.set_password_expire,1095,6,5,1,5,0,0,29.0,1.0,0.0,D:\BaiduNetdiskDownload\graduation_project\project_folder\ansible\modules\user.py,1095.0
ansible.modules.user.User.ssh_key_fingerprint,1256,4,3,1,3,0,0,10.0,1.0,0.0,D:\BaiduNetdiskDownload\graduation_project\project_folder\ansible\modules\user.py,1256.0
ansible.modules.user.User.ssh_key_gen,1165,7,6,1,6,0,0,90.0,1.0,0.0,D:\BaiduNetdiskDownload\graduation_project\project_folder\ansible\modules\user.py,1165.0
ansible.modules.user.User.user_exists,1055,8,4,4,4,0,0,26.0,1.0,0.0,D:\BaiduNetdiskDownload\graduation_project\project_folder\ansible\modules\user.py,1055.0
ansible.modules.user.User.user_group_membership,1040,10,2,8,2,0,0,14.0,1.0,0.0,D:\BaiduNetdiskDownload\graduation_project\project_folder\ansible\modules\user.py,1040.0
ansible.modules.user.User.user_info,1087,16,3,13,3,0,0,7.0,1.0,0.0,D:\BaiduNetdiskDownload\graduation_project\project_folder\ansible\modules\user.py,1087.0
ansible.modules.user.User.user_password,1125,7,4,3,4,0,0,18.0,1.0,0.0,D:\BaiduNetdiskDownload\graduation_project\project_folder\ansible\modules\user.py,1125.0
ansible.modules.user.getspnam,516,2,0,2,0,0,0,2.0,1.0,0.0,D:\BaiduNetdiskDownload\graduation_project\project_folder\ansible\modules\user.py,516.0
ansible.modules.user.main,3101,20,19,1,19,0,0,173.0,1.0,0.0,D:\BaiduNetdiskDownload\graduation_project\project_folder\ansible\modules\user.py,3101.0
ansible.modules.wait_for.LinuxTCPConnectionInfo.__init__,362,2,2,0,2,0,0,5.0,2.0,0.0,D:\BaiduNetdiskDownload\graduation_project\project_folder\ansible\modules\wait_for.py,362.0
ansible.modules.wait_for.LinuxTCPConnectionInfo._get_exclude_ips,368,3,2,1,2,0,0,7.0,1.0,0.0,D:\BaiduNetdiskDownload\graduation_project\project_folder\ansible\modules\wait_for.py,368.0
ansible.modules.wait_for.LinuxTCPConnectionInfo.get_active_connections_count,376,4,4,0,4,0,0,33.0,1.0,0.0,D:\BaiduNetdiskDownload\graduation_project\project_folder\ansible\modules\wait_for.py,376.0
ansible.modules.wait_for.TCPConnectionInfo.__init__,282,4,4,0,4,0,0,7.0,2.0,0.0,D:\BaiduNetdiskDownload\graduation_project\project_folder\ansible\modules\wait_for.py,282.0
ansible.modules.wait_for.TCPConnectionInfo.__new__,278,2,1,1,1,0,0,3.0,3.0,0.0,D:\BaiduNetdiskDownload\graduation_project\project_folder\ansible\modules\wait_for.py,278.0
ansible.modules.wait_for.TCPConnectionInfo._get_exclude_ips,290,3,2,1,2,0,0,7.0,1.0,0.0,D:\BaiduNetdiskDownload\graduation_project\project_folder\ansible\modules\wait_for.py,290.0
ansible.modules.wait_for.TCPConnectionInfo.get_active_connections_count,298,2,1,1,1,0,0,34.0,1.0,0.0,D:\BaiduNetdiskDownload\graduation_project\project_folder\ansible\modules\wait_for.py,298.0
ansible.modules.wait_for._convert_host_to_hex,431,4,2,2,2,0,0,25.0,1.0,0.0,D:\BaiduNetdiskDownload\graduation_project\project_folder\ansible\modules\wait_for.py,431.0
ansible.modules.wait_for._convert_host_to_ip,411,4,1,3,1,0,0,18.0,1.0,0.0,D:\BaiduNetdiskDownload\graduation_project\project_folder\ansible\modules\wait_for.py,411.0
ansible.modules.wait_for._timedelta_total_seconds,458,1,0,1,0,0,0,4.0,1.0,0.0,D:\BaiduNetdiskDownload\graduation_project\project_folder\ansible\modules\wait_for.py,458.0
ansible.modules.wait_for.get_connection_state_id,464,2,0,2,0,0,0,10.0,1.0,0.0,D:\BaiduNetdiskDownload\graduation_project\project_folder\ansible\modules\wait_for.py,464.0
ansible.modules.wait_for.main,476,16,15,1,15,0,0,223.0,1.0,0.0,D:\BaiduNetdiskDownload\graduation_project\project_folder\ansible\modules\wait_for.py,476.0
ansible.modules.yum_repository.YumRepo.__init__,488,3,2,1,2,0,0,21.0,2.0,0.0,D:\BaiduNetdiskDownload\graduation_project\project_folder\ansible\modules\yum_repository.py,488.0
ansible.modules.yum_repository.YumRepo.add,510,82,3,79,3,0,6,34.0,1.0,0.0,D:\BaiduNetdiskDownload\graduation_project\project_folder\ansible\modules\yum_repository.py,510.0
ansible.modules.yum_repository.YumRepo.dump,571,2,1,1,1,0,0,13.0,1.0,0.0,D:\BaiduNetdiskDownload\graduation_project\project_folder\ansible\modules\yum_repository.py,571.0
ansible.modules.yum_repository.YumRepo.remove,566,1,0,1,0,0,0,4.0,1.0,0.0,D:\BaiduNetdiskDownload\graduation_project\project_folder\ansible\modules\yum_repository.py,566.0
ansible.modules.yum_repository.YumRepo.save,545,3,2,1,2,0,0,20.0,1.0,0.0,D:\BaiduNetdiskDownload\graduation_project\project_folder\ansible\modules\yum_repository.py,545.0
ansible.modules.yum_repository.main,586,12,11,1,11,0,0,132.0,1.0,0.0,D:\BaiduNetdiskDownload\graduation_project\project_folder\ansible\modules\yum_repository.py,586.0
ansible.parsing.ajson.AnsibleJSONDecoder.object_hook,28,2,2,0,2,0,0,13.0,2.0,0.0,D:\BaiduNetdiskDownload\graduation_project\project_folder\ansible\parsing\ajson.py,28.0
ansible.parsing.ajson.AnsibleJSONDecoder.set_secrets,25,2,1,1,1,0,0,2.0,2.0,0.0,D:\BaiduNetdiskDownload\graduation_project\project_folder\ansible\parsing\ajson.py,25.0
ansible.parsing.dataloader.DataLoader.__init__,52,8,2,6,2,0,0,19.0,1.0,0.0,D:\BaiduNetdiskDownload\graduation_project\project_folder\ansible\parsing\dataloader.py,52.0
ansible.parsing.dataloader.DataLoader._create_content_tempfile,356,3,2,1,2,0,0,13.0,2.0,0.0,D:\BaiduNetdiskDownload\graduation_project\project_folder\ansible\parsing\dataloader.py,356.0
ansible.parsing.dataloader.DataLoader._decrypt_if_vault_data,140,4,2,2,2,0,0,12.0,2.0,0.0,D:\BaiduNetdiskDownload\graduation_project\project_folder\ansible\parsing\dataloader.py,140.0
ansible.parsing.dataloader.DataLoader._get_dir_vars_files,465,11,9,2,9,1,1,15.0,3.0,0.0,D:\BaiduNetdiskDownload\graduation_project\project_folder\ansible\parsing\dataloader.py,465.0
ansible.parsing.dataloader.DataLoader._get_file_contents,153,14,6,8,6,0,0,28.0,2.0,0.0,D:\BaiduNetdiskDownload\graduation_project\project_folder\ansible\parsing\dataloader.py,153.0
ansible.parsing.dataloader.DataLoader._is_role,208,5,3,2,3,0,0,33.0,2.0,0.0,D:\BaiduNetdiskDownload\graduation_project\project_folder\ansible\parsing\dataloader.py,208.0
ansible.parsing.dataloader.DataLoader.cleanup_all_tmp_files,420,7,3,4,3,0,0,10.0,1.0,0.0,D:\BaiduNetdiskDownload\graduation_project\project_folder\ansible\parsing\dataloader.py,420.0
ansible.parsing.dataloader.DataLoader.cleanup_tmp_file,410,1,0,1,0,0,0,9.0,2.0,0.0,D:\BaiduNetdiskDownload\graduation_project\project_folder\ansible\parsing\dataloader.py,410.0
ansible.parsing.dataloader.DataLoader.find_vars_files,431,10,8,2,8,0,0,33.0,3.0,0.0,D:\BaiduNetdiskDownload\graduation_project\project_folder\ansible\parsing\dataloader.py,431.0
ansible.parsing.dataloader.DataLoader.get_basedir,182,1,0,1,0,0,0,3.0,1.0,0.0,D:\BaiduNetdiskDownload\graduation_project\project_folder\ansible\parsing\dataloader.py,182.0
ansible.parsing.dataloader.DataLoader.get_real_file,370,15,9,6,9,0,0,39.0,2.0,0.0,D:\BaiduNetdiskDownload\graduation_project\project_folder\ansible\parsing\dataloader.py,370.0
ansible.parsing.dataloader.DataLoader.is_directory,127,5,2,3,2,0,0,3.0,2.0,0.0,D:\BaiduNetdiskDownload\graduation_project\project_folder\ansible\parsing\dataloader.py,127.0
ansible.parsing.dataloader.DataLoader.is_executable,135,2,2,0,2,0,0,4.0,2.0,0.0,D:\BaiduNetdiskDownload\graduation_project\project_folder\ansible\parsing\dataloader.py,135.0
ansible.parsing.dataloader.DataLoader.is_file,123,4,2,2,2,0,0,3.0,2.0,0.0,D:\BaiduNetdiskDownload\graduation_project\project_folder\ansible\parsing\dataloader.py,123.0
ansible.parsing.dataloader.DataLoader.list_directory,131,2,1,1,1,0,0,3.0,2.0,0.0,D:\BaiduNetdiskDownload\graduation_project\project_folder\ansible\parsing\dataloader.py,131.0
ansible.parsing.dataloader.DataLoader.load,76,2,1,1,1,0,0,3.0,2.0,0.0,D:\BaiduNetdiskDownload\graduation_project\project_folder\ansible\parsing\dataloader.py,76.0
ansible.parsing.dataloader.DataLoader.load_from_file,80,15,5,10,5,0,0,38.0,2.0,0.0,D:\BaiduNetdiskDownload\graduation_project\project_folder\ansible\parsing\dataloader.py,80.0
ansible.parsing.dataloader.DataLoader.path_dwim,192,18,4,14,4,0,0,15.0,2.0,0.0,D:\BaiduNetdiskDownload\graduation_project\project_folder\ansible\parsing\dataloader.py,192.0
ansible.parsing.dataloader.DataLoader.path_dwim_relative,242,12,10,2,10,0,0,54.0,4.0,0.0,D:\BaiduNetdiskDownload\graduation_project\project_folder\ansible\parsing\dataloader.py,242.0
ansible.parsing.dataloader.DataLoader.path_dwim_relative_stack,297,17,14,3,14,0,0,58.0,4.0,0.0,D:\BaiduNetdiskDownload\graduation_project\project_folder\ansible\parsing\dataloader.py,297.0
ansible.parsing.dataloader.DataLoader.path_exists,119,9,2,7,2,0,0,3.0,2.0,0.0,D:\BaiduNetdiskDownload\graduation_project\project_folder\ansible\parsing\dataloader.py,119.0
ansible.parsing.dataloader.DataLoader.set_basedir,186,6,1,5,1,0,0,5.0,2.0,0.0,D:\BaiduNetdiskDownload\graduation_project\project_folder\ansible\parsing\dataloader.py,186.0
ansible.parsing.dataloader.DataLoader.set_vault_secrets,73,4,0,4,0,0,0,2.0,3.0,0.0,D:\BaiduNetdiskDownload\graduation_project\project_folder\ansible\parsing\dataloader.py,73.0
ansible.parsing.mod_args.ModuleArgsParser.__init__,103,2,0,2,0,0,0,18.0,1.0,0.0,D:\BaiduNetdiskDownload\graduation_project\project_folder\ansible\parsing\mod_args.py,103.0
ansible.parsing.mod_args.ModuleArgsParser._normalize_new_style_args,195,2,1,1,1,0,0,26.0,3.0,0.0,D:\BaiduNetdiskDownload\graduation_project\project_folder\ansible\parsing\mod_args.py,195.0
ansible.parsing.mod_args.ModuleArgsParser._normalize_old_style_args,222,3,2,1,2,0,0,37.0,2.0,0.0,D:\BaiduNetdiskDownload\graduation_project\project_folder\ansible\parsing\mod_args.py,222.0
ansible.parsing.mod_args.ModuleArgsParser._normalize_parameters,136,10,9,1,9,0,0,58.0,2.0,0.0,D:\BaiduNetdiskDownload\graduation_project\project_folder\ansible\parsing\mod_args.py,136.0
ansible.parsing.mod_args.ModuleArgsParser._split_module_string,122,4,3,1,3,0,0,13.0,2.0,0.0,D:\BaiduNetdiskDownload\graduation_project\project_folder\ansible\parsing\mod_args.py,122.0
ansible.parsing.mod_args.ModuleArgsParser.parse,260,10,8,2,8,0,0,92.0,1.0,0.0,D:\BaiduNetdiskDownload\graduation_project\project_folder\ansible\parsing\mod_args.py,260.0
ansible.parsing.plugin_docs._init_doc_dict,33,4,1,3,1,0,0,3.0,1.0,0.0,D:\BaiduNetdiskDownload\graduation_project\project_folder\ansible\parsing\plugin_docs.py,33.0
ansible.parsing.plugin_docs._var2string,26,2,1,1,1,0,0,5.0,1.0,0.0,D:\BaiduNetdiskDownload\graduation_project\project_folder\ansible\parsing\plugin_docs.py,26.0
ansible.parsing.plugin_docs.read_docstring,170,5,4,1,4,0,0,21.0,1.0,0.0,D:\BaiduNetdiskDownload\graduation_project\project_folder\ansible\parsing\plugin_docs.py,38.0
ansible.parsing.plugin_docs.read_docstring_from_python_file,123,8,7,1,7,0,0,45.0,1.0,0.0,D:\BaiduNetdiskDownload\graduation_project\project_folder\ansible\parsing\plugin_docs.py,123.0
ansible.parsing.plugin_docs.read_docstring_from_python_module,61,11,10,1,10,0,0,60.0,1.0,0.0,D:\BaiduNetdiskDownload\graduation_project\project_folder\ansible\parsing\plugin_docs.py,61.0
ansible.parsing.plugin_docs.read_docstring_from_yaml_file,38,5,4,1,4,0,0,21.0,1.0,0.0,D:\BaiduNetdiskDownload\graduation_project\project_folder\ansible\parsing\plugin_docs.py,38.0
ansible.parsing.plugin_docs.read_docstub,191,8,7,1,7,0,0,36.0,1.0,0.0,D:\BaiduNetdiskDownload\graduation_project\project_folder\ansible\parsing\plugin_docs.py,191.0
ansible.parsing.quoting.is_quoted,21,2,0,2,0,0,0,2.0,1.0,0.0,D:\BaiduNetdiskDownload\graduation_project\project_folder\ansible\parsing\quoting.py,21.0
ansible.parsing.quoting.unquote,25,4,1,3,1,0,0,5.0,1.0,0.0,D:\BaiduNetdiskDownload\graduation_project\project_folder\ansible\parsing\quoting.py,25.0
ansible.parsing.splitter._count_jinja2_blocks,116,1,0,1,0,0,0,13.0,4.0,0.0,D:\BaiduNetdiskDownload\graduation_project\project_folder\ansible\parsing\splitter.py,116.0
ansible.parsing.splitter._decode_escapes,40,1,0,1,0,0,0,5.0,1.0,2.0,D:\BaiduNetdiskDownload\graduation_project\project_folder\ansible\parsing\splitter.py,40.0
ansible.parsing.splitter._get_quote_state,96,1,0,1,0,0,0,18.0,2.0,0.0,D:\BaiduNetdiskDownload\graduation_project\project_folder\ansible\parsing\splitter.py,96.0
ansible.parsing.splitter.join_args,131,2,1,1,1,0,0,12.0,1.0,0.0,D:\BaiduNetdiskDownload\graduation_project\project_folder\ansible\parsing\splitter.py,131.0
ansible.parsing.splitter.parse_kv,47,18,9,9,9,0,0,47.0,1.0,0.0,D:\BaiduNetdiskDownload\graduation_project\project_folder\ansible\parsing\splitter.py,47.0
ansible.parsing.splitter.split_args,145,8,5,3,5,0,0,138.0,1.0,0.0,D:\BaiduNetdiskDownload\graduation_project\project_folder\ansible\parsing\splitter.py,145.0
ansible.parsing.utils.addresses.parse_address,168,7,3,4,3,0,0,47.0,1.0,0.0,D:\BaiduNetdiskDownload\graduation_project\project_folder\ansible\parsing\utils\addresses.py,168.0
ansible.parsing.utils.jsonify.jsonify,23,1,0,1,0,0,0,14.0,1.0,0.0,D:\BaiduNetdiskDownload\graduation_project\project_folder\ansible\parsing\utils\jsonify.py,23.0
ansible.parsing.utils.yaml._handle_error,23,1,0,1,0,0,0,19.0,4.0,0.0,D:\BaiduNetdiskDownload\graduation_project\project_folder\ansible\parsing\utils\yaml.py,23.0
ansible.parsing.utils.yaml._safe_load,44,2,1,1,1,0,0,11.0,1.0,0.0,D:\BaiduNetdiskDownload\graduation_project\project_folder\ansible\parsing\utils\yaml.py,44.0
ansible.parsing.utils.yaml.from_yaml,57,8,3,5,3,0,0,26.0,1.0,0.0,D:\BaiduNetdiskDownload\graduation_project\project_folder\ansible\parsing\utils\yaml.py,57.0
ansible.parsing.vault.__init__.ClientScriptVaultSecret.__init__,471,3,2,1,2,0,0,6.0,1.0,0.0,D:\BaiduNetdiskDownload\graduation_project\project_folder\ansible\parsing\vault\__init__.py,471.0
ansible.parsing.vault.__init__.ClientScriptVaultSecret._build_command,502,1,1,0,1,0,0,6.0,1.0,0.0,D:\BaiduNetdiskDownload\graduation_project\project_folder\ansible\parsing\vault\__init__.py,502.0
ansible.parsing.vault.__init__.ClientScriptVaultSecret._check_results,493,1,1,0,1,0,0,8.0,4.0,0.0,D:\BaiduNetdiskDownload\graduation_project\project_folder\ansible\parsing\vault\__init__.py,493.0
ansible.parsing.vault.__init__.ClientScriptVaultSecret._run,478,1,1,0,1,0,0,14.0,2.0,0.0,D:\BaiduNetdiskDownload\graduation_project\project_folder\ansible\parsing\vault\__init__.py,478.0
ansible.parsing.vault.__init__.FileVaultSecret.__init__,377,1,0,1,0,0,0,10.0,1.0,0.0,D:\BaiduNetdiskDownload\graduation_project\project_folder\ansible\parsing\vault\__init__.py,377.0
ansible.parsing.vault.__init__.FileVaultSecret._read_file,399,6,5,1,5,0,0,21.0,2.0,0.0,D:\BaiduNetdiskDownload\graduation_project\project_folder\ansible\parsing\vault\__init__.py,399.0
ansible.parsing.vault.__init__.FileVaultSecret.load,396,1,1,0,1,0,0,2.0,1.0,0.0,D:\BaiduNetdiskDownload\graduation_project\project_folder\ansible\parsing\vault\__init__.py,396.0
ansible.parsing.vault.__init__.PromptVaultSecret.__init__,287,1,0,1,0,0,0,8.0,1.0,0.0,D:\BaiduNetdiskDownload\graduation_project\project_folder\ansible\parsing\vault\__init__.py,287.0
ansible.parsing.vault.__init__.PromptVaultSecret.ask_vault_passwords,303,7,6,1,6,0,0,23.0,1.0,0.0,D:\BaiduNetdiskDownload\graduation_project\project_folder\ansible\parsing\vault\__init__.py,303.0
ansible.parsing.vault.__init__.PromptVaultSecret.confirm,327,2,1,1,1,0,0,6.0,3.0,0.0,D:\BaiduNetdiskDownload\graduation_project\project_folder\ansible\parsing\vault\__init__.py,327.0
ansible.parsing.vault.__init__.PromptVaultSecret.load,300,2,1,1,1,0,0,2.0,1.0,0.0,D:\BaiduNetdiskDownload\graduation_project\project_folder\ansible\parsing\vault\__init__.py,300.0
ansible.parsing.vault.__init__.ScriptVaultSecret._build_command,464,1,0,1,0,0,0,2.0,1.0,0.0,D:\BaiduNetdiskDownload\graduation_project\project_folder\ansible\parsing\vault\__init__.py,464.0
ansible.parsing.vault.__init__.ScriptVaultSecret._check_results,459,2,1,1,1,0,0,4.0,4.0,0.0,D:\BaiduNetdiskDownload\graduation_project\project_folder\ansible\parsing\vault\__init__.py,459.0
ansible.parsing.vault.__init__.ScriptVaultSecret._read_file,428,5,5,0,5,0,0,16.0,2.0,0.0,D:\BaiduNetdiskDownload\graduation_project\project_folder\ansible\parsing\vault\__init__.py,428.0
ansible.parsing.vault.__init__.ScriptVaultSecret._run,445,2,1,1,1,0,0,13.0,2.0,0.0,D:\BaiduNetdiskDownload\graduation_project\project_folder\ansible\parsing\vault\__init__.py,445.0
ansible.parsing.vault.__init__.VaultAES256.__init__,1151,1,1,0,1,0,0,3.0,1.0,0.0,D:\BaiduNetdiskDownload\graduation_project\project_folder\ansible\parsing\vault\__init__.py,1151.0
ansible.parsing.vault.__init__.VaultAES256._create_key_cryptography,1156,1,0,1,0,0,0,10.0,4.0,0.0,D:\BaiduNetdiskDownload\graduation_project\project_folder\ansible\parsing\vault\__init__.py,1156.0
ansible.parsing.vault.__init__.VaultAES256._decrypt_cryptography,1236,2,1,1,1,0,0,18.0,6.0,0.0,D:\BaiduNetdiskDownload\graduation_project\project_folder\ansible\parsing\vault\__init__.py,1236.0
ansible.parsing.vault.__init__.VaultAES256._encrypt_cryptography,1187,2,1,1,1,0,0,13.0,4.0,0.0,D:\BaiduNetdiskDownload\graduation_project\project_folder\ansible\parsing\vault\__init__.py,1187.0
ansible.parsing.vault.__init__.VaultAES256._gen_key_initctr,1168,4,2,2,2,0,0,17.0,3.0,0.0,D:\BaiduNetdiskDownload\graduation_project\project_folder\ansible\parsing\vault\__init__.py,1168.0
ansible.parsing.vault.__init__.VaultAES256._get_salt,1202,2,1,1,1,0,0,5.0,1.0,0.0,D:\BaiduNetdiskDownload\graduation_project\project_folder\ansible\parsing\vault\__init__.py,1202.0
ansible.parsing.vault.__init__.VaultAES256.decrypt,1275,4,4,0,4,0,0,18.0,3.0,0.0,D:\BaiduNetdiskDownload\graduation_project\project_folder\ansible\parsing\vault\__init__.py,1275.0
ansible.parsing.vault.__init__.VaultAES256.encrypt,1209,6,6,0,6,0,0,25.0,3.0,0.0,D:\BaiduNetdiskDownload\graduation_project\project_folder\ansible\parsing\vault\__init__.py,1209.0
ansible.parsing.vault.__init__.VaultEditor.__init__,762,2,1,1,1,0,0,3.0,1.0,0.0,D:\BaiduNetdiskDownload\graduation_project\project_folder\ansible\parsing\vault\__init__.py,762.0
ansible.parsing.vault.__init__.VaultEditor._edit_file_helper,837,11,9,2,9,0,0,42.0,3.0,0.0,D:\BaiduNetdiskDownload\graduation_project\project_folder\ansible\parsing\vault\__init__.py,837.0
ansible.parsing.vault.__init__.VaultEditor._editor_shell_command,1128,3,2,1,2,0,0,6.0,2.0,0.0,D:\BaiduNetdiskDownload\graduation_project\project_folder\ansible\parsing\vault\__init__.py,1128.0
ansible.parsing.vault.__init__.VaultEditor._real_path,880,4,0,4,0,0,0,7.0,2.0,0.0,D:\BaiduNetdiskDownload\graduation_project\project_folder\ansible\parsing\vault\__init__.py,880.0
ansible.parsing.vault.__init__.VaultEditor._shred_file,804,3,1,2,1,0,0,36.0,2.0,0.0,D:\BaiduNetdiskDownload\graduation_project\project_folder\ansible\parsing\vault\__init__.py,767.0
ansible.parsing.vault.__init__.VaultEditor._shred_file_custom,767,2,1,1,1,0,0,36.0,2.0,0.0,D:\BaiduNetdiskDownload\graduation_project\project_folder\ansible\parsing\vault\__init__.py,767.0
ansible.parsing.vault.__init__.VaultEditor.create_file,919,6,5,1,5,0,0,14.0,3.0,0.0,D:\BaiduNetdiskDownload\graduation_project\project_folder\ansible\parsing\vault\__init__.py,919.0
ansible.parsing.vault.__init__.VaultEditor.decrypt_file,906,5,4,1,4,0,0,12.0,2.0,0.0,D:\BaiduNetdiskDownload\graduation_project\project_folder\ansible\parsing\vault\__init__.py,906.0
ansible.parsing.vault.__init__.VaultEditor.edit_file,934,8,7,1,7,0,0,31.0,2.0,0.0,D:\BaiduNetdiskDownload\graduation_project\project_folder\ansible\parsing\vault\__init__.py,934.0
ansible.parsing.vault.__init__.VaultEditor.encrypt_bytes,888,1,0,1,0,0,0,5.0,3.0,0.0,D:\BaiduNetdiskDownload\graduation_project\project_folder\ansible\parsing\vault\__init__.py,888.0
ansible.parsing.vault.__init__.VaultEditor.encrypt_file,894,4,3,1,3,0,0,11.0,3.0,0.0,D:\BaiduNetdiskDownload\graduation_project\project_folder\ansible\parsing\vault\__init__.py,894.0
ansible.parsing.vault.__init__.VaultEditor.plaintext,966,3,2,1,2,0,0,10.0,2.0,0.0,D:\BaiduNetdiskDownload\graduation_project\project_folder\ansible\parsing\vault\__init__.py,966.0
ansible.parsing.vault.__init__.VaultEditor.read_data,1018,8,2,6,2,0,0,15.0,2.0,0.0,D:\BaiduNetdiskDownload\graduation_project\project_folder\ansible\parsing\vault\__init__.py,1018.0
ansible.parsing.vault.__init__.VaultEditor.rekey_file,978,10,9,1,9,0,0,39.0,3.0,0.0,D:\BaiduNetdiskDownload\graduation_project\project_folder\ansible\parsing\vault\__init__.py,978.0
ansible.parsing.vault.__init__.VaultEditor.shuffle_files,1113,1,0,1,0,0,0,14.0,3.0,0.0,D:\BaiduNetdiskDownload\graduation_project\project_folder\ansible\parsing\vault\__init__.py,1113.0
ansible.parsing.vault.__init__.VaultEditor.write_data,1034,9,4,5,4,0,0,78.0,3.0,0.0,D:\BaiduNetdiskDownload\graduation_project\project_folder\ansible\parsing\vault\__init__.py,1034.0
ansible.parsing.vault.__init__.VaultLib.__init__,576,8,0,8,0,0,0,4.0,1.0,0.0,D:\BaiduNetdiskDownload\graduation_project\project_folder\ansible\parsing\vault\__init__.py,576.0
ansible.parsing.vault.__init__.VaultLib.decrypt,631,2,1,1,1,0,0,13.0,2.0,0.0,D:\BaiduNetdiskDownload\graduation_project\project_folder\ansible\parsing\vault\__init__.py,631.0
ansible.parsing.vault.__init__.VaultLib.decrypt_and_get_vault_id,645,15,12,3,12,0,0,113.0,2.0,0.0,D:\BaiduNetdiskDownload\graduation_project\project_folder\ansible\parsing\vault\__init__.py,645.0
ansible.parsing.vault.__init__.VaultLib.encrypt,585,10,8,2,8,0,0,45.0,2.0,0.0,D:\BaiduNetdiskDownload\graduation_project\project_folder\ansible\parsing\vault\__init__.py,585.0
ansible.parsing.vault.__init__.VaultLib.is_encrypted,582,1,1,0,1,0,0,2.0,1.0,0.0,D:\BaiduNetdiskDownload\graduation_project\project_folder\ansible\parsing\vault\__init__.py,582.0
ansible.parsing.vault.__init__.VaultSecret.__init__,268,2,0,2,0,0,0,3.0,1.0,0.0,D:\BaiduNetdiskDownload\graduation_project\project_folder\ansible\parsing\vault\__init__.py,268.0
ansible.parsing.vault.__init__._parse_vaulttext,225,3,2,1,2,0,0,17.0,1.0,0.0,D:\BaiduNetdiskDownload\graduation_project\project_folder\ansible\parsing\vault\__init__.py,127.0
ansible.parsing.vault.__init__._parse_vaulttext_envelope,127,6,5,1,5,0,0,17.0,1.0,0.0,D:\BaiduNetdiskDownload\graduation_project\project_folder\ansible\parsing\vault\__init__.py,127.0
ansible.parsing.vault.__init__._unhexlify,218,2,0,2,0,0,0,5.0,1.0,0.0,D:\BaiduNetdiskDownload\graduation_project\project_folder\ansible\parsing\vault\__init__.py,218.0
ansible.parsing.vault.__init__.format_vaulttext_envelope,177,5,4,1,4,0,0,39.0,2.0,0.0,D:\BaiduNetdiskDownload\graduation_project\project_folder\ansible\parsing\vault\__init__.py,177.0
ansible.parsing.vault.__init__.get_file_vault_secret,349,8,7,1,7,0,0,24.0,0.0,0.0,D:\BaiduNetdiskDownload\graduation_project\project_folder\ansible\parsing\vault\__init__.py,349.0
ansible.parsing.vault.__init__.is_encrypted,84,9,3,6,3,0,0,20.0,1.0,0.0,D:\BaiduNetdiskDownload\graduation_project\project_folder\ansible\parsing\vault\__init__.py,84.0
ansible.parsing.vault.__init__.is_encrypted_file,106,3,2,1,2,0,0,19.0,1.0,0.0,D:\BaiduNetdiskDownload\graduation_project\project_folder\ansible\parsing\vault\__init__.py,106.0
ansible.parsing.vault.__init__.match_best_secret,525,3,1,2,1,0,0,10.0,2.0,0.0,D:\BaiduNetdiskDownload\graduation_project\project_folder\ansible\parsing\vault\__init__.py,525.0
ansible.parsing.vault.__init__.match_encrypt_secret,557,6,4,2,4,0,0,16.0,1.0,0.0,D:\BaiduNetdiskDownload\graduation_project\project_folder\ansible\parsing\vault\__init__.py,557.0
ansible.parsing.vault.__init__.match_encrypt_vault_id_secret,537,5,4,1,4,0,0,18.0,1.0,0.0,D:\BaiduNetdiskDownload\graduation_project\project_folder\ansible\parsing\vault\__init__.py,537.0
ansible.parsing.vault.__init__.match_secrets,516,2,0,2,0,0,0,7.0,2.0,0.0,D:\BaiduNetdiskDownload\graduation_project\project_folder\ansible\parsing\vault\__init__.py,516.0
ansible.parsing.vault.__init__.parse_vaulttext,234,2,1,1,1,0,0,29.0,1.0,0.0,D:\BaiduNetdiskDownload\graduation_project\project_folder\ansible\parsing\vault\__init__.py,146.0
ansible.parsing.vault.__init__.parse_vaulttext_envelope,146,4,1,3,1,0,0,29.0,1.0,0.0,D:\BaiduNetdiskDownload\graduation_project\project_folder\ansible\parsing\vault\__init__.py,146.0
ansible.parsing.vault.__init__.script_is_client,335,2,1,1,1,0,0,12.0,1.0,0.0,D:\BaiduNetdiskDownload\graduation_project\project_folder\ansible\parsing\vault\__init__.py,335.0
ansible.parsing.vault.__init__.verify_secret_is_not_empty,253,3,0,3,0,0,0,10.0,1.0,0.0,D:\BaiduNetdiskDownload\graduation_project\project_folder\ansible\parsing\vault\__init__.py,253.0
ansible.parsing.yaml.constructor.AnsibleConstructor.__init__,34,2,1,1,1,0,0,6.0,1.0,0.0,D:\BaiduNetdiskDownload\graduation_project\project_folder\ansible\parsing\yaml\constructor.py,34.0
ansible.parsing.yaml.constructor.AnsibleConstructor._node_position_info,133,5,0,5,0,0,0,13.0,2.0,0.0,D:\BaiduNetdiskDownload\graduation_project\project_folder\ansible\parsing\yaml\constructor.py,133.0
ansible.parsing.yaml.constructor.AnsibleConstructor.construct_mapping,48,5,4,1,4,0,0,40.0,2.0,0.0,D:\BaiduNetdiskDownload\graduation_project\project_folder\ansible\parsing\yaml\constructor.py,48.0
ansible.parsing.yaml.constructor.AnsibleConstructor.construct_vault_encrypted_unicode,99,3,3,0,3,0,0,15.0,2.0,0.0,D:\BaiduNetdiskDownload\graduation_project\project_folder\ansible\parsing\yaml\constructor.py,99.0
ansible.parsing.yaml.constructor.AnsibleConstructor.construct_yaml_map,41,2,2,0,2,0,0,6.0,2.0,0.0,D:\BaiduNetdiskDownload\graduation_project\project_folder\ansible\parsing\yaml\constructor.py,41.0
ansible.parsing.yaml.constructor.AnsibleConstructor.construct_yaml_seq,115,2,2,0,2,0,0,5.0,2.0,0.0,D:\BaiduNetdiskDownload\graduation_project\project_folder\ansible\parsing\yaml\constructor.py,115.0
ansible.parsing.yaml.constructor.AnsibleConstructor.construct_yaml_str,89,1,1,0,1,0,0,9.0,2.0,0.0,D:\BaiduNetdiskDownload\graduation_project\project_folder\ansible\parsing\yaml\constructor.py,89.0
ansible.parsing.yaml.constructor.AnsibleConstructor.construct_yaml_unsafe,121,1,1,0,1,0,0,11.0,2.0,0.0,D:\BaiduNetdiskDownload\graduation_project\project_folder\ansible\parsing\yaml\constructor.py,121.0
ansible.parsing.yaml.dumper.represent_vault_encrypted_unicode,43,1,1,0,1,0,0,2.0,2.0,0.0,D:\BaiduNetdiskDownload\graduation_project\project_folder\ansible\parsing\yaml\dumper.py,43.0
ansible.parsing.yaml.loader.AnsibleLoader.__init__,27,9,1,8,1,0,0,7.0,2.0,0.0,D:\BaiduNetdiskDownload\graduation_project\project_folder\ansible\parsing\yaml\loader.py,27.0
ansible.parsing.yaml.objects.AnsibleVaultEncryptedUnicode.__add__,196,1,1,0,1,0,0,6.0,2.0,0.0,D:\BaiduNetdiskDownload\graduation_project\project_folder\ansible\parsing\yaml\objects.py,196.0
ansible.parsing.yaml.objects.AnsibleVaultEncryptedUnicode.__init__,87,4,1,3,1,0,0,13.0,2.0,0.0,D:\BaiduNetdiskDownload\graduation_project\project_folder\ansible\parsing\yaml\objects.py,87.0
ansible.parsing.yaml.objects.AnsibleVaultEncryptedUnicode.__radd__,203,1,1,0,1,0,0,4.0,2.0,0.0,D:\BaiduNetdiskDownload\graduation_project\project_folder\ansible\parsing\yaml\objects.py,203.0
ansible.parsing.yaml.objects.AnsibleVaultEncryptedUnicode.__reversed__,124,1,1,0,1,0,0,4.0,1.0,0.0,D:\BaiduNetdiskDownload\graduation_project\project_folder\ansible\parsing\yaml\objects.py,124.0
ansible.parsing.yaml.objects.AnsibleVaultEncryptedUnicode.__rmod__,216,1,1,0,1,0,0,2.0,2.0,0.0,D:\BaiduNetdiskDownload\graduation_project\project_folder\ansible\parsing\yaml\objects.py,216.0
ansible.parsing.yaml.objects.AnsibleVaultEncryptedUnicode.__unicode__,132,1,1,0,1,0,0,2.0,1.0,0.0,D:\BaiduNetdiskDownload\graduation_project\project_folder\ansible\parsing\yaml\objects.py,132.0
ansible.parsing.yaml.objects.AnsibleVaultEncryptedUnicode.capitalize,220,6,1,5,1,1,1,2.0,1.0,0.0,D:\BaiduNetdiskDownload\graduation_project\project_folder\ansible\parsing\yaml\objects.py,220.0
ansible.parsing.yaml.objects.AnsibleVaultEncryptedUnicode.casefold,223,2,1,1,1,1,1,2.0,1.0,0.0,D:\BaiduNetdiskDownload\graduation_project\project_folder\ansible\parsing\yaml\objects.py,223.0
ansible.parsing.yaml.objects.AnsibleVaultEncryptedUnicode.center,226,2,1,1,1,1,1,2.0,3.0,0.0,D:\BaiduNetdiskDownload\graduation_project\project_folder\ansible\parsing\yaml\objects.py,226.0
ansible.parsing.yaml.objects.AnsibleVaultEncryptedUnicode.count,229,2,1,1,1,1,1,4.0,2.0,0.0,D:\BaiduNetdiskDownload\graduation_project\project_folder\ansible\parsing\yaml\objects.py,229.0
ansible.parsing.yaml.objects.AnsibleVaultEncryptedUnicode.data,102,1,1,0,1,0,0,2.0,2.0,0.0,D:\BaiduNetdiskDownload\graduation_project\project_folder\ansible\parsing\yaml\objects.py,102.0
ansible.parsing.yaml.objects.AnsibleVaultEncryptedUnicode.data,108,1,1,0,1,0,0,2.0,2.0,0.0,D:\BaiduNetdiskDownload\graduation_project\project_folder\ansible\parsing\yaml\objects.py,102.0
ansible.parsing.yaml.objects.AnsibleVaultEncryptedUnicode.encode,135,1,1,0,1,0,0,2.0,1.0,0.0,D:\BaiduNetdiskDownload\graduation_project\project_folder\ansible\parsing\yaml\objects.py,135.0
ansible.parsing.yaml.objects.AnsibleVaultEncryptedUnicode.endswith,234,82,1,81,1,1,1,2.0,2.0,0.0,D:\BaiduNetdiskDownload\graduation_project\project_folder\ansible\parsing\yaml\objects.py,234.0
ansible.parsing.yaml.objects.AnsibleVaultEncryptedUnicode.expandtabs,237,3,1,2,1,1,1,2.0,1.0,0.0,D:\BaiduNetdiskDownload\graduation_project\project_folder\ansible\parsing\yaml\objects.py,237.0
ansible.parsing.yaml.objects.AnsibleVaultEncryptedUnicode.find,240,10,1,9,1,1,1,4.0,2.0,0.0,D:\BaiduNetdiskDownload\graduation_project\project_folder\ansible\parsing\yaml\objects.py,240.0
ansible.parsing.yaml.objects.AnsibleVaultEncryptedUnicode.format,245,214,1,213,1,1,1,2.0,3.0,0.0,D:\BaiduNetdiskDownload\graduation_project\project_folder\ansible\parsing\yaml\objects.py,245.0
ansible.parsing.yaml.objects.AnsibleVaultEncryptedUnicode.format_map,248,2,1,1,1,1,1,2.0,2.0,0.0,D:\BaiduNetdiskDownload\graduation_project\project_folder\ansible\parsing\yaml\objects.py,248.0
ansible.parsing.yaml.objects.AnsibleVaultEncryptedUnicode.index,251,17,1,16,1,1,1,2.0,2.0,0.0,D:\BaiduNetdiskDownload\graduation_project\project_folder\ansible\parsing\yaml\objects.py,251.0
ansible.parsing.yaml.objects.AnsibleVaultEncryptedUnicode.is_encrypted,111,2,1,1,1,1,1,2.0,1.0,0.0,D:\BaiduNetdiskDownload\graduation_project\project_folder\ansible\parsing\yaml\objects.py,111.0
ansible.parsing.yaml.objects.AnsibleVaultEncryptedUnicode.isalnum,257,2,1,1,1,1,1,2.0,1.0,0.0,D:\BaiduNetdiskDownload\graduation_project\project_folder\ansible\parsing\yaml\objects.py,257.0
ansible.parsing.yaml.objects.AnsibleVaultEncryptedUnicode.isalpha,254,2,1,1,1,1,1,2.0,1.0,0.0,D:\BaiduNetdiskDownload\graduation_project\project_folder\ansible\parsing\yaml\objects.py,254.0
ansible.parsing.yaml.objects.AnsibleVaultEncryptedUnicode.isascii,260,3,1,2,1,1,1,2.0,1.0,0.0,D:\BaiduNetdiskDownload\graduation_project\project_folder\ansible\parsing\yaml\objects.py,260.0
ansible.parsing.yaml.objects.AnsibleVaultEncryptedUnicode.isdecimal,263,2,1,1,1,1,1,2.0,1.0,0.0,D:\BaiduNetdiskDownload\graduation_project\project_folder\ansible\parsing\yaml\objects.py,263.0
ansible.parsing.yaml.objects.AnsibleVaultEncryptedUnicode.isdigit,266,8,1,7,1,1,1,2.0,1.0,0.0,D:\BaiduNetdiskDownload\graduation_project\project_folder\ansible\parsing\yaml\objects.py,266.0
ansible.parsing.yaml.objects.AnsibleVaultEncryptedUnicode.isidentifier,269,3,1,2,1,1,1,2.0,1.0,0.0,D:\BaiduNetdiskDownload\graduation_project\project_folder\ansible\parsing\yaml\objects.py,269.0
ansible.parsing.yaml.objects.AnsibleVaultEncryptedUnicode.islower,272,2,1,1,1,1,1,2.0,1.0,0.0,D:\BaiduNetdiskDownload\graduation_project\project_folder\ansible\parsing\yaml\objects.py,272.0
ansible.parsing.yaml.objects.AnsibleVaultEncryptedUnicode.isnumeric,275,2,1,1,1,1,1,2.0,1.0,0.0,D:\BaiduNetdiskDownload\graduation_project\project_folder\ansible\parsing\yaml\objects.py,275.0
ansible.parsing.yaml.objects.AnsibleVaultEncryptedUnicode.isprintable,278,2,1,1,1,1,1,2.0,1.0,0.0,D:\BaiduNetdiskDownload\graduation_project\project_folder\ansible\parsing\yaml\objects.py,278.0
ansible.parsing.yaml.objects.AnsibleVaultEncryptedUnicode.isspace,281,2,1,1,1,1,1,2.0,1.0,0.0,D:\BaiduNetdiskDownload\graduation_project\project_folder\ansible\parsing\yaml\objects.py,281.0
ansible.parsing.yaml.objects.AnsibleVaultEncryptedUnicode.istitle,284,2,1,1,1,1,1,2.0,1.0,0.0,D:\BaiduNetdiskDownload\graduation_project\project_folder\ansible\parsing\yaml\objects.py,284.0
ansible.parsing.yaml.objects.AnsibleVaultEncryptedUnicode.isupper,287,2,1,1,1,1,1,2.0,1.0,0.0,D:\BaiduNetdiskDownload\graduation_project\project_folder\ansible\parsing\yaml\objects.py,287.0
ansible.parsing.yaml.objects.AnsibleVaultEncryptedUnicode.join,290,302,1,301,1,1,1,2.0,2.0,0.0,D:\BaiduNetdiskDownload\graduation_project\project_folder\ansible\parsing\yaml\objects.py,290.0
ansible.parsing.yaml.objects.AnsibleVaultEncryptedUnicode.ljust,293,2,1,1,1,1,1,2.0,3.0,0.0,D:\BaiduNetdiskDownload\graduation_project\project_folder\ansible\parsing\yaml\objects.py,293.0
ansible.parsing.yaml.objects.AnsibleVaultEncryptedUnicode.lower,296,69,1,68,1,1,1,2.0,1.0,0.0,D:\BaiduNetdiskDownload\graduation_project\project_folder\ansible\parsing\yaml\objects.py,296.0
ansible.parsing.yaml.objects.AnsibleVaultEncryptedUnicode.lstrip,299,22,1,21,1,1,1,2.0,1.0,0.0,D:\BaiduNetdiskDownload\graduation_project\project_folder\ansible\parsing\yaml\objects.py,299.0
ansible.parsing.yaml.objects.AnsibleVaultEncryptedUnicode.partition,304,9,1,8,1,1,1,2.0,2.0,0.0,D:\BaiduNetdiskDownload\graduation_project\project_folder\ansible\parsing\yaml\objects.py,304.0
ansible.parsing.yaml.objects.AnsibleVaultEncryptedUnicode.replace,307,79,1,78,1,1,1,6.0,3.0,0.0,D:\BaiduNetdiskDownload\graduation_project\project_folder\ansible\parsing\yaml\objects.py,307.0
ansible.parsing.yaml.objects.AnsibleVaultEncryptedUnicode.rfind,314,3,1,2,1,1,1,4.0,2.0,0.0,D:\BaiduNetdiskDownload\graduation_project\project_folder\ansible\parsing\yaml\objects.py,314.0
ansible.parsing.yaml.objects.AnsibleVaultEncryptedUnicode.rindex,319,4,1,3,1,1,1,2.0,2.0,0.0,D:\BaiduNetdiskDownload\graduation_project\project_folder\ansible\parsing\yaml\objects.py,319.0
ansible.parsing.yaml.objects.AnsibleVaultEncryptedUnicode.rjust,322,3,1,2,1,1,1,2.0,3.0,0.0,D:\BaiduNetdiskDownload\graduation_project\project_folder\ansible\parsing\yaml\objects.py,322.0
ansible.parsing.yaml.objects.AnsibleVaultEncryptedUnicode.rpartition,325,5,1,4,1,1,1,2.0,2.0,0.0,D:\BaiduNetdiskDownload\graduation_project\project_folder\ansible\parsing\yaml\objects.py,325.0
ansible.parsing.yaml.objects.AnsibleVaultEncryptedUnicode.rsplit,334,10,1,9,1,1,1,2.0,1.0,0.0,D:\BaiduNetdiskDownload\graduation_project\project_folder\ansible\parsing\yaml\objects.py,334.0
ansible.parsing.yaml.objects.AnsibleVaultEncryptedUnicode.rstrip,328,65,1,64,1,1,1,2.0,1.0,0.0,D:\BaiduNetdiskDownload\graduation_project\project_folder\ansible\parsing\yaml\objects.py,328.0
ansible.parsing.yaml.objects.AnsibleVaultEncryptedUnicode.split,331,323,1,322,1,1,1,2.0,1.0,0.0,D:\BaiduNetdiskDownload\graduation_project\project_folder\ansible\parsing\yaml\objects.py,331.0
ansible.parsing.yaml.objects.AnsibleVaultEncryptedUnicode.splitlines,337,115,1,114,1,1,1,2.0,1.0,0.0,D:\BaiduNetdiskDownload\graduation_project\project_folder\ansible\parsing\yaml\objects.py,337.0
ansible.parsing.yaml.objects.AnsibleVaultEncryptedUnicode.startswith,340,187,1,186,1,1,1,2.0,2.0,0.0,D:\BaiduNetdiskDownload\graduation_project\project_folder\ansible\parsing\yaml\objects.py,340.0
ansible.parsing.yaml.objects.AnsibleVaultEncryptedUnicode.strip,343,208,1,207,1,1,1,2.0,1.0,0.0,D:\BaiduNetdiskDownload\graduation_project\project_folder\ansible\parsing\yaml\objects.py,343.0
ansible.parsing.yaml.objects.AnsibleVaultEncryptedUnicode.swapcase,346,2,1,1,1,1,1,2.0,1.0,0.0,D:\BaiduNetdiskDownload\graduation_project\project_folder\ansible\parsing\yaml\objects.py,346.0
ansible.parsing.yaml.objects.AnsibleVaultEncryptedUnicode.title,349,6,1,5,1,1,1,2.0,1.0,0.0,D:\BaiduNetdiskDownload\graduation_project\project_folder\ansible\parsing\yaml\objects.py,349.0
ansible.parsing.yaml.objects.AnsibleVaultEncryptedUnicode.translate,352,6,1,5,1,1,1,2.0,2.0,0.0,D:\BaiduNetdiskDownload\graduation_project\project_folder\ansible\parsing\yaml\objects.py,352.0
ansible.parsing.yaml.objects.AnsibleVaultEncryptedUnicode.upper,355,22,1,21,1,1,1,2.0,1.0,0.0,D:\BaiduNetdiskDownload\graduation_project\project_folder\ansible\parsing\yaml\objects.py,355.0
ansible.parsing.yaml.objects.AnsibleVaultEncryptedUnicode.zfill,358,4,1,3,1,1,1,2.0,2.0,0.0,D:\BaiduNetdiskDownload\graduation_project\project_folder\ansible\parsing\yaml\objects.py,358.0
ansible.playbook.__init__.Playbook.__init__,39,4,1,3,1,0,0,7.0,2.0,0.0,D:\BaiduNetdiskDownload\graduation_project\project_folder\ansible\playbook\__init__.py,39.0
ansible.playbook.__init__.Playbook._load_playbook_data,53,11,9,2,9,0,0,57.0,3.0,0.0,D:\BaiduNetdiskDownload\graduation_project\project_folder\ansible\playbook\__init__.py,53.0
ansible.playbook.__init__.Playbook.get_plays,114,1,0,1,0,0,0,2.0,1.0,0.0,D:\BaiduNetdiskDownload\graduation_project\project_folder\ansible\playbook\__init__.py,114.0
ansible.playbook.__init__.Playbook.load,48,2,2,0,2,0,0,4.0,1.0,0.0,D:\BaiduNetdiskDownload\graduation_project\project_folder\ansible\playbook\__init__.py,48.0
ansible.playbook.attribute.ConnectionFieldAttribute.__get__,182,1,1,0,1,0,0,16.0,2.0,0.0,D:\BaiduNetdiskDownload\graduation_project\project_folder\ansible\playbook\attribute.py,182.0
ansible.playbook.base.Base.get_dep_chain,752,3,1,2,1,1,1,6.0,1.0,0.0,D:\BaiduNetdiskDownload\graduation_project\project_folder\ansible\playbook\base.py,752.0
ansible.playbook.base.Base.get_path,739,3,0,3,0,0,0,12.0,1.0,0.0,D:\BaiduNetdiskDownload\graduation_project\project_folder\ansible\playbook\base.py,739.0
ansible.playbook.base.Base.get_search_path,759,9,4,5,4,0,0,18.0,1.0,0.0,D:\BaiduNetdiskDownload\graduation_project\project_folder\ansible\playbook\base.py,759.0
ansible.playbook.base.FieldAttributeBase.__init__,98,1,1,0,1,0,0,17.0,1.0,0.0,D:\BaiduNetdiskDownload\graduation_project\project_folder\ansible\playbook\base.py,98.0
ansible.playbook.base.FieldAttributeBase._extend_value,599,3,0,3,0,0,0,24.0,3.0,0.0,D:\BaiduNetdiskDownload\graduation_project\project_folder\ansible\playbook\base.py,599.0
ansible.playbook.base.FieldAttributeBase._fattributes,86,1,1,0,1,0,0,11.0,1.0,0.0,D:\BaiduNetdiskDownload\graduation_project\project_folder\ansible\playbook\base.py,86.0
ansible.playbook.base.FieldAttributeBase._load_module_defaults,233,7,7,0,7,0,0,54.0,3.0,0.0,D:\BaiduNetdiskDownload\graduation_project\project_folder\ansible\playbook\base.py,233.0
ansible.playbook.base.FieldAttributeBase._load_vars,575,2,1,1,1,0,0,23.0,3.0,2.0,D:\BaiduNetdiskDownload\graduation_project\project_folder\ansible\playbook\base.py,575.0
ansible.playbook.base.FieldAttributeBase._post_validate_debugger,192,2,2,0,2,0,0,6.0,4.0,0.0,D:\BaiduNetdiskDownload\graduation_project\project_folder\ansible\playbook\base.py,192.0
ansible.playbook.base.FieldAttributeBase._resolve_action,388,3,1,2,1,0,0,14.0,2.0,0.0,D:\BaiduNetdiskDownload\graduation_project\project_folder\ansible\playbook\base.py,388.0
ansible.playbook.base.FieldAttributeBase._resolve_group,303,12,10,2,10,1,1,84.0,2.0,0.0,D:\BaiduNetdiskDownload\graduation_project\project_folder\ansible\playbook\base.py,303.0
ansible.playbook.base.FieldAttributeBase._validate_attributes,199,1,0,1,0,0,0,10.0,2.0,0.0,D:\BaiduNetdiskDownload\graduation_project\project_folder\ansible\playbook\base.py,199.0
ansible.playbook.base.FieldAttributeBase.copy,414,1,1,0,1,0,0,24.0,1.0,0.0,D:\BaiduNetdiskDownload\graduation_project\project_folder\ansible\playbook\base.py,414.0
ansible.playbook.base.FieldAttributeBase.deserialize,676,2,2,0,2,0,0,21.0,2.0,0.0,D:\BaiduNetdiskDownload\graduation_project\project_folder\ansible\playbook\base.py,676.0
ansible.playbook.base.FieldAttributeBase.dump_attrs,624,8,1,7,1,0,0,12.0,1.0,0.0,D:\BaiduNetdiskDownload\graduation_project\project_folder\ansible\playbook\base.py,624.0
ansible.playbook.base.FieldAttributeBase.dump_me,120,4,3,1,3,1,1,13.0,1.0,0.0,D:\BaiduNetdiskDownload\graduation_project\project_folder\ansible\playbook\base.py,120.0
ansible.playbook.base.FieldAttributeBase.from_attrs,637,2,1,1,1,0,0,20.0,2.0,0.0,D:\BaiduNetdiskDownload\graduation_project\project_folder\ansible\playbook\base.py,637.0
ansible.playbook.base.FieldAttributeBase.get_ds,180,4,0,4,0,0,0,5.0,1.0,0.0,D:\BaiduNetdiskDownload\graduation_project\project_folder\ansible\playbook\base.py,180.0
ansible.playbook.base.FieldAttributeBase.get_validated_value,439,10,6,4,6,0,0,52.0,5.0,0.0,D:\BaiduNetdiskDownload\graduation_project\project_folder\ansible\playbook\base.py,439.0
ansible.playbook.base.FieldAttributeBase.load_data,138,6,5,1,5,0,0,41.0,2.0,0.0,D:\BaiduNetdiskDownload\graduation_project\project_folder\ansible\playbook\base.py,138.0
ansible.playbook.base.FieldAttributeBase.post_validate,506,5,5,0,5,0,0,68.0,2.0,0.0,D:\BaiduNetdiskDownload\graduation_project\project_folder\ansible\playbook\base.py,506.0
ansible.playbook.base.FieldAttributeBase.preprocess_data,134,1,0,1,0,0,0,3.0,2.0,0.0,D:\BaiduNetdiskDownload\graduation_project\project_folder\ansible\playbook\base.py,134.0
ansible.playbook.base.FieldAttributeBase.serialize,658,1,1,0,1,0,0,17.0,1.0,0.0,D:\BaiduNetdiskDownload\graduation_project\project_folder\ansible\playbook\base.py,658.0
ansible.playbook.base.FieldAttributeBase.set_to_context,492,2,0,2,0,0,0,13.0,2.0,0.0,D:\BaiduNetdiskDownload\graduation_project\project_folder\ansible\playbook\base.py,492.0
ansible.playbook.base.FieldAttributeBase.squash,403,1,0,1,0,0,0,10.0,1.0,0.0,D:\BaiduNetdiskDownload\graduation_project\project_folder\ansible\playbook\base.py,403.0
ansible.playbook.base.FieldAttributeBase.validate,210,3,2,1,2,0,0,22.0,1.0,0.0,D:\BaiduNetdiskDownload\graduation_project\project_folder\ansible\playbook\base.py,210.0
ansible.playbook.base._validate_action_group_metadata,33,6,5,1,5,0,0,37.0,3.0,0.0,D:\BaiduNetdiskDownload\graduation_project\project_folder\ansible\playbook\base.py,33.0
ansible.playbook.block.Block.__init__,45,6,0,6,0,0,0,14.0,1.0,0.0,D:\BaiduNetdiskDownload\graduation_project\project_folder\ansible\playbook\block.py,45.0
ansible.playbook.block.Block.__repr__,60,1,1,0,1,0,0,2.0,1.0,0.0,D:\BaiduNetdiskDownload\graduation_project\project_folder\ansible\playbook\block.py,60.0
ansible.playbook.block.Block._get_parent_attribute,292,2,2,0,2,0,0,72.0,2.0,0.0,D:\BaiduNetdiskDownload\graduation_project\project_folder\ansible\playbook\block.py,292.0
ansible.playbook.block.Block._load_always,146,1,1,0,1,0,0,14.0,3.0,0.0,D:\BaiduNetdiskDownload\graduation_project\project_folder\ansible\playbook\block.py,146.0
ansible.playbook.block.Block._load_block,116,1,1,0,1,0,0,14.0,3.0,0.0,D:\BaiduNetdiskDownload\graduation_project\project_folder\ansible\playbook\block.py,116.0
ansible.playbook.block.Block._load_rescue,131,1,1,0,1,0,0,14.0,3.0,0.0,D:\BaiduNetdiskDownload\graduation_project\project_folder\ansible\playbook\block.py,131.0
ansible.playbook.block.Block.all_parents_static,419,2,1,1,1,1,1,14.0,1.0,0.0,D:\BaiduNetdiskDownload\graduation_project\project_folder\ansible\playbook\block.py,419.0
ansible.playbook.block.Block.copy,176,5,2,3,2,1,1,44.0,1.0,2.0,D:\BaiduNetdiskDownload\graduation_project\project_folder\ansible\playbook\block.py,176.0
ansible.playbook.block.Block.deserialize,242,6,6,0,6,0,0,37.0,2.0,0.0,D:\BaiduNetdiskDownload\graduation_project\project_folder\ansible\playbook\block.py,242.0
ansible.playbook.block.Block.filter_tagged_tasks,365,7,3,4,3,0,0,26.0,2.0,2.0,D:\BaiduNetdiskDownload\graduation_project\project_folder\ansible\playbook\block.py,365.0
ansible.playbook.block.Block.get_dep_chain,167,6,1,5,1,1,1,8.0,1.0,0.0,D:\BaiduNetdiskDownload\graduation_project\project_folder\ansible\playbook\block.py,167.0
ansible.playbook.block.Block.get_first_parent_include,434,2,1,1,1,1,1,7.0,1.0,0.0,D:\BaiduNetdiskDownload\graduation_project\project_folder\ansible\playbook\block.py,434.0
ansible.playbook.block.Block.get_include_params,413,2,1,1,1,1,1,5.0,1.0,0.0,D:\BaiduNetdiskDownload\graduation_project\project_folder\ansible\playbook\block.py,413.0
ansible.playbook.block.Block.get_tasks,392,3,2,1,2,0,0,17.0,1.0,2.0,D:\BaiduNetdiskDownload\graduation_project\project_folder\ansible\playbook\block.py,392.0
ansible.playbook.block.Block.get_vars,71,3,2,1,2,1,1,14.0,1.0,0.0,D:\BaiduNetdiskDownload\graduation_project\project_folder\ansible\playbook\block.py,71.0
ansible.playbook.block.Block.has_tasks,410,4,0,4,0,0,0,2.0,1.0,0.0,D:\BaiduNetdiskDownload\graduation_project\project_folder\ansible\playbook\block.py,410.0
ansible.playbook.block.Block.is_block,93,3,0,3,0,0,0,8.0,1.0,0.0,D:\BaiduNetdiskDownload\graduation_project\project_folder\ansible\playbook\block.py,93.0
ansible.playbook.block.Block.load,87,6,2,4,2,0,0,4.0,1.0,0.0,D:\BaiduNetdiskDownload\graduation_project\project_folder\ansible\playbook\block.py,87.0
ansible.playbook.block.Block.preprocess_data,102,1,1,0,1,0,0,13.0,2.0,0.0,D:\BaiduNetdiskDownload\graduation_project\project_folder\ansible\playbook\block.py,102.0
ansible.playbook.block.Block.serialize,221,4,3,1,3,1,1,20.0,1.0,0.0,D:\BaiduNetdiskDownload\graduation_project\project_folder\ansible\playbook\block.py,221.0
ansible.playbook.block.Block.set_loader,280,3,2,1,2,1,1,11.0,2.0,0.0,D:\BaiduNetdiskDownload\graduation_project\project_folder\ansible\playbook\block.py,280.0
ansible.playbook.collectionsearch.CollectionSearch._load_collections,41,4,4,0,4,0,0,22.0,3.0,0.0,D:\BaiduNetdiskDownload\graduation_project\project_folder\ansible\playbook\collectionsearch.py,41.0
ansible.playbook.collectionsearch._ensure_default_collection,17,2,1,1,1,0,0,16.0,0.0,0.0,D:\BaiduNetdiskDownload\graduation_project\project_folder\ansible\playbook\collectionsearch.py,17.0
ansible.playbook.conditional.Conditional.__init__,39,4,1,3,1,0,0,10.0,1.0,0.0,D:\BaiduNetdiskDownload\graduation_project\project_folder\ansible\playbook\conditional.py,39.0
ansible.playbook.conditional.Conditional._check_conditional,86,3,2,1,2,0,0,28.0,5.0,0.0,D:\BaiduNetdiskDownload\graduation_project\project_folder\ansible\playbook\conditional.py,86.0
ansible.playbook.conditional.Conditional.evaluate_conditional,54,5,1,4,1,0,0,6.0,4.0,0.0,D:\BaiduNetdiskDownload\graduation_project\project_folder\ansible\playbook\conditional.py,54.0
ansible.playbook.conditional.Conditional.evaluate_conditional_with_result,61,5,3,2,3,0,0,24.0,4.0,0.0,D:\BaiduNetdiskDownload\graduation_project\project_folder\ansible\playbook\conditional.py,61.0
ansible.playbook.handler.Handler.__init__,29,1,0,1,0,0,0,6.0,1.0,0.0,D:\BaiduNetdiskDownload\graduation_project\project_folder\ansible\playbook\handler.py,29.0
ansible.playbook.handler.Handler.__repr__,36,1,1,0,1,0,0,3.0,1.0,0.0,D:\BaiduNetdiskDownload\graduation_project\project_folder\ansible\playbook\handler.py,36.0
ansible.playbook.handler.Handler.clear_hosts,54,1,0,1,0,0,0,2.0,1.0,0.0,D:\BaiduNetdiskDownload\graduation_project\project_folder\ansible\playbook\handler.py,54.0
ansible.playbook.handler.Handler.is_host_notified,57,2,0,2,0,0,0,2.0,2.0,0.0,D:\BaiduNetdiskDownload\graduation_project\project_folder\ansible\playbook\handler.py,57.0
ansible.playbook.handler.Handler.load,41,2,1,1,1,0,0,3.0,1.0,0.0,D:\BaiduNetdiskDownload\graduation_project\project_folder\ansible\playbook\handler.py,41.0
ansible.playbook.handler.Handler.notify_host,45,4,2,2,2,0,0,5.0,2.0,0.0,D:\BaiduNetdiskDownload\graduation_project\project_folder\ansible\playbook\handler.py,45.0
ansible.playbook.handler_task_include.HandlerTaskInclude.load,30,1,1,0,1,0,0,8.0,1.0,0.0,D:\BaiduNetdiskDownload\graduation_project\project_folder\ansible\playbook\handler_task_include.py,30.0
ansible.playbook.helpers.load_list_of_blocks,31,10,3,7,3,0,0,49.0,2.0,0.0,D:\BaiduNetdiskDownload\graduation_project\project_folder\ansible\playbook\helpers.py,31.0
ansible.playbook.helpers.load_list_of_roles,304,4,2,2,2,0,0,24.0,2.0,0.0,D:\BaiduNetdiskDownload\graduation_project\project_folder\ansible\playbook\helpers.py,304.0
ansible.playbook.helpers.load_list_of_tasks,82,20,17,3,17,0,0,220.0,2.0,0.0,D:\BaiduNetdiskDownload\graduation_project\project_folder\ansible\playbook\helpers.py,82.0
ansible.playbook.included_file.IncludedFile.__init__,37,1,0,1,0,0,0,8.0,5.0,0.0,D:\BaiduNetdiskDownload\graduation_project\project_folder\ansible\playbook\included_file.py,37.0
ansible.playbook.included_file.IncludedFile.add_host,46,2,1,1,1,0,0,5.0,2.0,0.0,D:\BaiduNetdiskDownload\graduation_project\project_folder\ansible\playbook\included_file.py,46.0
ansible.playbook.included_file.IncludedFile.process_include_results,63,15,13,2,13,0,0,163.0,4.0,0.0,D:\BaiduNetdiskDownload\graduation_project\project_folder\ansible\playbook\included_file.py,63.0
ansible.playbook.loop_control.LoopControl.__init__,33,1,0,1,0,0,0,2.0,1.0,0.0,D:\BaiduNetdiskDownload\graduation_project\project_folder\ansible\playbook\loop_control.py,33.0
ansible.playbook.loop_control.LoopControl.load,37,3,2,1,2,0,0,3.0,1.0,0.0,D:\BaiduNetdiskDownload\graduation_project\project_folder\ansible\playbook\loop_control.py,37.0
ansible.playbook.play.Play.__init__,86,3,0,3,0,0,0,13.0,1.0,0.0,D:\BaiduNetdiskDownload\graduation_project\project_folder\ansible\playbook\play.py,86.0
ansible.playbook.play.Play.__repr__,100,1,1,0,1,0,0,2.0,1.0,0.0,D:\BaiduNetdiskDownload\graduation_project\project_folder\ansible\playbook\play.py,100.0
ansible.playbook.play.Play._compile_roles,242,2,1,1,1,0,0,20.0,1.0,0.0,D:\BaiduNetdiskDownload\graduation_project\project_folder\ansible\playbook\play.py,242.0
ansible.playbook.play.Play._load_handlers,192,2,2,0,2,0,0,13.0,3.0,0.0,D:\BaiduNetdiskDownload\graduation_project\project_folder\ansible\playbook\play.py,192.0
ansible.playbook.play.Play._load_post_tasks,182,1,1,0,1,0,0,9.0,3.0,0.0,D:\BaiduNetdiskDownload\graduation_project\project_folder\ansible\playbook\play.py,182.0
ansible.playbook.play.Play._load_pre_tasks,172,1,1,0,1,0,0,9.0,3.0,0.0,D:\BaiduNetdiskDownload\graduation_project\project_folder\ansible\playbook\play.py,172.0
ansible.playbook.play.Play._load_roles,206,2,2,0,2,0,0,22.0,3.0,0.0,D:\BaiduNetdiskDownload\graduation_project\project_folder\ansible\playbook\play.py,206.0
ansible.playbook.play.Play._load_tasks,162,1,1,0,1,0,0,9.0,3.0,0.0,D:\BaiduNetdiskDownload\graduation_project\project_folder\ansible\playbook\play.py,162.0
ansible.playbook.play.Play._load_vars_prompt,229,2,2,0,2,0,0,12.0,3.0,0.0,D:\BaiduNetdiskDownload\graduation_project\project_folder\ansible\playbook\play.py,229.0
ansible.playbook.play.Play._validate_hosts,103,2,2,0,2,0,0,16.0,4.0,0.0,D:\BaiduNetdiskDownload\graduation_project\project_folder\ansible\playbook\play.py,103.0
ansible.playbook.play.Play.compile,279,7,7,0,7,0,0,15.0,1.0,0.0,D:\BaiduNetdiskDownload\graduation_project\project_folder\ansible\playbook\play.py,263.0
ansible.playbook.play.Play.compile_roles_handlers,263,3,2,1,2,0,0,15.0,1.0,0.0,D:\BaiduNetdiskDownload\graduation_project\project_folder\ansible\playbook\play.py,263.0
ansible.playbook.play.Play.copy,390,3,1,2,1,1,1,8.0,1.0,0.0,D:\BaiduNetdiskDownload\graduation_project\project_folder\ansible\playbook\play.py,390.0
ansible.playbook.play.Play.deserialize,373,3,3,0,3,0,0,16.0,2.0,0.0,D:\BaiduNetdiskDownload\graduation_project\project_folder\ansible\playbook\play.py,373.0
ansible.playbook.play.Play.get_name,120,3,2,1,2,0,0,11.0,1.0,0.0,D:\BaiduNetdiskDownload\graduation_project\project_folder\ansible\playbook\play.py,120.0
ansible.playbook.play.Play.get_roles,348,1,0,1,0,0,0,2.0,1.0,0.0,D:\BaiduNetdiskDownload\graduation_project\project_folder\ansible\playbook\play.py,348.0
ansible.playbook.play.Play.get_tasks,351,1,1,0,1,0,0,8.0,1.0,0.0,D:\BaiduNetdiskDownload\graduation_project\project_folder\ansible\playbook\play.py,351.0
ansible.playbook.play.Play.get_vars,335,1,1,0,1,0,0,2.0,1.0,0.0,D:\BaiduNetdiskDownload\graduation_project\project_folder\ansible\playbook\play.py,335.0
ansible.playbook.play.Play.get_vars_files,338,1,0,1,0,0,0,6.0,1.0,0.0,D:\BaiduNetdiskDownload\graduation_project\project_folder\ansible\playbook\play.py,338.0
ansible.playbook.play.Play.load,133,2,1,1,1,0,0,5.0,1.0,0.0,D:\BaiduNetdiskDownload\graduation_project\project_folder\ansible\playbook\play.py,133.0
ansible.playbook.play.Play.serialize,360,2,2,0,2,0,0,12.0,1.0,0.0,D:\BaiduNetdiskDownload\graduation_project\project_folder\ansible\playbook\play.py,360.0
ansible.playbook.play_context.PlayContext.__init__,116,4,2,2,2,0,0,29.0,1.0,0.0,D:\BaiduNetdiskDownload\graduation_project\project_folder\ansible\playbook\play_context.py,116.0
ansible.playbook.play_context.PlayContext.set_attributes_from_cli,160,1,0,1,0,0,0,16.0,1.0,0.0,D:\BaiduNetdiskDownload\graduation_project\project_folder\ansible\playbook\play_context.py,160.0
ansible.playbook.play_context.PlayContext.set_attributes_from_play,157,1,0,1,0,0,0,2.0,2.0,0.0,D:\BaiduNetdiskDownload\graduation_project\project_folder\ansible\playbook\play_context.py,157.0
ansible.playbook.play_context.PlayContext.set_attributes_from_plugin,146,2,0,2,0,0,0,10.0,2.0,0.0,D:\BaiduNetdiskDownload\graduation_project\project_folder\ansible\playbook\play_context.py,146.0
ansible.playbook.play_context.PlayContext.set_task_and_variable_override,177,5,3,2,3,0,0,133.0,4.0,0.0,D:\BaiduNetdiskDownload\graduation_project\project_folder\ansible\playbook\play_context.py,177.0
ansible.playbook.playbook_include.PlaybookInclude._preprocess_import,154,3,2,1,2,0,0,16.0,5.0,0.0,D:\BaiduNetdiskDownload\graduation_project\project_folder\ansible\playbook\playbook_include.py,154.0
ansible.playbook.playbook_include.PlaybookInclude.load,46,1,0,1,0,0,0,2.0,2.0,0.0,D:\BaiduNetdiskDownload\graduation_project\project_folder\ansible\playbook\playbook_include.py,46.0
ansible.playbook.playbook_include.PlaybookInclude.load_data,49,10,10,0,10,0,0,74.0,2.0,0.0,D:\BaiduNetdiskDownload\graduation_project\project_folder\ansible\playbook\playbook_include.py,49.0
ansible.playbook.playbook_include.PlaybookInclude.preprocess_data,124,2,2,0,2,0,0,29.0,2.0,0.0,D:\BaiduNetdiskDownload\graduation_project\project_folder\ansible\playbook\playbook_include.py,124.0
ansible.playbook.role.__init__.Role.__eq__,174,1,1,0,1,0,0,5.0,2.0,0.0,D:\BaiduNetdiskDownload\graduation_project\project_folder\ansible\playbook\role\__init__.py,174.0
ansible.playbook.role.__init__.Role.__init__,101,6,1,5,1,0,0,43.0,1.0,0.0,D:\BaiduNetdiskDownload\graduation_project\project_folder\ansible\playbook\role\__init__.py,101.0
ansible.playbook.role.__init__.Role.__repr__,145,1,1,0,1,0,0,2.0,1.0,0.0,D:\BaiduNetdiskDownload\graduation_project\project_folder\ansible\playbook\role\__init__.py,145.0
ansible.playbook.role.__init__.Role._create_validation_task,347,1,0,1,0,0,0,30.0,3.0,0.0,D:\BaiduNetdiskDownload\graduation_project\project_folder\ansible\playbook\role\__init__.py,347.0
ansible.playbook.role.__init__.Role._get_hash_dict,157,4,3,1,3,0,0,16.0,1.0,0.0,D:\BaiduNetdiskDownload\graduation_project\project_folder\ansible\playbook\role\__init__.py,157.0
ansible.playbook.role.__init__.Role._get_role_argspecs,290,3,2,1,2,0,0,27.0,1.0,0.0,D:\BaiduNetdiskDownload\graduation_project\project_folder\ansible\playbook\role\__init__.py,290.0
ansible.playbook.role.__init__.Role._load_dependencies,432,3,2,1,2,0,3,12.0,1.0,0.0,D:\BaiduNetdiskDownload\graduation_project\project_folder\ansible\playbook\role\__init__.py,432.0
ansible.playbook.role.__init__.Role._load_role_data,207,11,10,1,10,0,3,82.0,2.0,0.0,D:\BaiduNetdiskDownload\graduation_project\project_folder\ansible\playbook\role\__init__.py,207.0
ansible.playbook.role.__init__.Role._load_role_yaml,378,10,8,2,8,0,0,53.0,2.0,0.0,D:\BaiduNetdiskDownload\graduation_project\project_folder\ansible\playbook\role\__init__.py,378.0
ansible.playbook.role.__init__.Role._prepend_validation_task,318,2,1,1,1,0,0,28.0,3.0,0.0,D:\BaiduNetdiskDownload\graduation_project\project_folder\ansible\playbook\role\__init__.py,318.0
ansible.playbook.role.__init__.Role.add_parent,447,2,1,1,1,0,0,7.0,2.0,0.0,D:\BaiduNetdiskDownload\graduation_project\project_folder\ansible\playbook\role\__init__.py,447.0
ansible.playbook.role.__init__.Role.compile,589,5,5,0,5,0,0,49.0,2.0,0.0,D:\BaiduNetdiskDownload\graduation_project\project_folder\ansible\playbook\role\__init__.py,589.0
ansible.playbook.role.__init__.Role.deserialize,665,9,5,4,5,1,1,32.0,2.0,0.0,D:\BaiduNetdiskDownload\graduation_project\project_folder\ansible\playbook\role\__init__.py,665.0
ansible.playbook.role.__init__.Role.get_all_dependencies,535,7,3,4,3,1,1,14.0,1.0,0.0,D:\BaiduNetdiskDownload\graduation_project\project_folder\ansible\playbook\role\__init__.py,535.0
ansible.playbook.role.__init__.Role.get_default_vars,465,5,3,2,3,1,1,11.0,1.0,0.0,D:\BaiduNetdiskDownload\graduation_project\project_folder\ansible\playbook\role\__init__.py,465.0
ansible.playbook.role.__init__.Role.get_dep_chain,458,2,2,0,2,0,0,6.0,1.0,0.0,D:\BaiduNetdiskDownload\graduation_project\project_folder\ansible\playbook\role\__init__.py,458.0
ansible.playbook.role.__init__.Role.get_direct_dependencies,532,5,0,5,0,0,0,2.0,1.0,0.0,D:\BaiduNetdiskDownload\graduation_project\project_folder\ansible\playbook\role\__init__.py,532.0
ansible.playbook.role.__init__.Role.get_handler_blocks,553,7,4,3,4,1,1,27.0,2.0,0.0,D:\BaiduNetdiskDownload\graduation_project\project_folder\ansible\playbook\role\__init__.py,553.0
ansible.playbook.role.__init__.Role.get_inherited_vars,477,2,1,1,1,0,0,11.0,1.0,0.0,D:\BaiduNetdiskDownload\graduation_project\project_folder\ansible\playbook\role\__init__.py,477.0
ansible.playbook.role.__init__.Role.get_name,148,3,1,2,1,0,0,4.0,1.0,0.0,D:\BaiduNetdiskDownload\graduation_project\project_folder\ansible\playbook\role\__init__.py,148.0
ansible.playbook.role.__init__.Role.get_role_params,489,3,1,2,1,0,0,9.0,1.0,0.0,D:\BaiduNetdiskDownload\graduation_project\project_folder\ansible\playbook\role\__init__.py,489.0
ansible.playbook.role.__init__.Role.get_role_path,153,2,0,2,0,0,0,3.0,1.0,0.0,D:\BaiduNetdiskDownload\graduation_project\project_folder\ansible\playbook\role\__init__.py,153.0
ansible.playbook.role.__init__.Role.get_vars,499,5,5,0,5,0,0,32.0,1.0,0.0,D:\BaiduNetdiskDownload\graduation_project\project_folder\ansible\playbook\role\__init__.py,499.0
ansible.playbook.role.__init__.Role.has_run,581,2,0,2,0,0,0,7.0,2.0,0.0,D:\BaiduNetdiskDownload\graduation_project\project_folder\ansible\playbook\role\__init__.py,581.0
ansible.playbook.role.__init__.Role.load,181,6,5,1,5,0,3,25.0,2.0,0.0,D:\BaiduNetdiskDownload\graduation_project\project_folder\ansible\playbook\role\__init__.py,181.0
ansible.playbook.role.__init__.Role.serialize,639,4,3,1,3,1,1,25.0,1.0,0.0,D:\BaiduNetdiskDownload\graduation_project\project_folder\ansible\playbook\role\__init__.py,639.0
ansible.playbook.role.__init__.Role.set_loader,698,1,1,0,1,0,0,6.0,2.0,0.0,D:\BaiduNetdiskDownload\graduation_project\project_folder\ansible\playbook\role\__init__.py,698.0
ansible.playbook.role.__init__.hash_params,51,4,3,1,3,1,1,46.0,1.0,0.0,D:\BaiduNetdiskDownload\graduation_project\project_folder\ansible\playbook\role\__init__.py,51.0
ansible.playbook.role.definition.RoleDefinition._load_role_name,112,4,3,1,3,0,0,22.0,2.0,0.0,D:\BaiduNetdiskDownload\graduation_project\project_folder\ansible\playbook\role\definition.py,112.0
ansible.playbook.role.definition.RoleDefinition._load_role_path,135,10,9,1,9,0,0,67.0,2.0,0.0,D:\BaiduNetdiskDownload\graduation_project\project_folder\ansible\playbook\role\definition.py,135.0
ansible.playbook.role.definition.RoleDefinition._split_role_params,203,2,1,1,1,0,0,25.0,2.0,0.0,D:\BaiduNetdiskDownload\graduation_project\project_folder\ansible\playbook\role\definition.py,203.0
ansible.playbook.role.definition.RoleDefinition.get_name,235,1,1,0,1,0,0,4.0,1.0,0.0,D:\BaiduNetdiskDownload\graduation_project\project_folder\ansible\playbook\role\definition.py,235.0
ansible.playbook.role.definition.RoleDefinition.load,64,1,1,0,1,0,0,2.0,1.0,0.0,D:\BaiduNetdiskDownload\graduation_project\project_folder\ansible\playbook\role\definition.py,64.0
ansible.playbook.role.definition.RoleDefinition.preprocess_data,67,3,3,0,3,0,0,44.0,2.0,0.0,D:\BaiduNetdiskDownload\graduation_project\project_folder\ansible\playbook\role\definition.py,67.0
ansible.playbook.role.include.RoleInclude.__init__,38,1,0,1,0,0,0,3.0,1.0,0.0,D:\BaiduNetdiskDownload\graduation_project\project_folder\ansible\playbook\role\include.py,38.0
ansible.playbook.role.include.RoleInclude.load,43,4,2,2,2,0,0,10.0,2.0,0.0,D:\BaiduNetdiskDownload\graduation_project\project_folder\ansible\playbook\role\include.py,43.0
ansible.playbook.role.metadata.RoleMetadata.__init__,45,3,0,3,0,0,0,3.0,1.0,0.0,D:\BaiduNetdiskDownload\graduation_project\project_folder\ansible\playbook\role\metadata.py,45.0
ansible.playbook.role.metadata.RoleMetadata._load_dependencies,61,3,3,0,3,0,0,49.0,3.0,0.0,D:\BaiduNetdiskDownload\graduation_project\project_folder\ansible\playbook\role\metadata.py,61.0
ansible.playbook.role.metadata.RoleMetadata.deserialize,117,1,0,1,0,0,0,3.0,2.0,0.0,D:\BaiduNetdiskDownload\graduation_project\project_folder\ansible\playbook\role\metadata.py,117.0
ansible.playbook.role.metadata.RoleMetadata.load,50,2,1,1,1,0,0,10.0,2.0,0.0,D:\BaiduNetdiskDownload\graduation_project\project_folder\ansible\playbook\role\metadata.py,50.0
ansible.playbook.role.requirement.RoleRequirement.__init__,46,2,0,2,0,0,0,2.0,1.0,0.0,D:\BaiduNetdiskDownload\graduation_project\project_folder\ansible\playbook\role\requirement.py,46.0
ansible.playbook.role.requirement.RoleRequirement.repo_url_to_role_name,50,3,2,1,2,0,0,14.0,1.0,0.0,D:\BaiduNetdiskDownload\graduation_project\project_folder\ansible\playbook\role\requirement.py,50.0
ansible.playbook.role.requirement.RoleRequirement.role_yaml_parse,66,12,7,5,7,0,0,56.0,1.0,0.0,D:\BaiduNetdiskDownload\graduation_project\project_folder\ansible\playbook\role\requirement.py,66.0
ansible.playbook.role.requirement.RoleRequirement.scm_archive_role,124,2,1,1,1,0,0,3.0,1.0,0.0,D:\BaiduNetdiskDownload\graduation_project\project_folder\ansible\playbook\role\requirement.py,124.0
ansible.playbook.role_include.IncludeRole.__init__,54,1,0,1,0,0,0,8.0,1.0,0.0,D:\BaiduNetdiskDownload\graduation_project\project_folder\ansible\playbook\role_include.py,54.0
ansible.playbook.role_include.IncludeRole.copy,157,2,1,1,1,1,1,10.0,1.0,0.0,D:\BaiduNetdiskDownload\graduation_project\project_folder\ansible\playbook\role_include.py,157.0
ansible.playbook.role_include.IncludeRole.get_block_list,67,9,6,3,6,0,0,50.0,1.0,0.0,D:\BaiduNetdiskDownload\graduation_project\project_folder\ansible\playbook\role_include.py,67.0
ansible.playbook.role_include.IncludeRole.get_include_params,168,1,1,0,1,0,0,7.0,1.0,0.0,D:\BaiduNetdiskDownload\graduation_project\project_folder\ansible\playbook\role_include.py,168.0
ansible.playbook.role_include.IncludeRole.get_name,63,1,0,1,0,0,0,3.0,1.0,0.0,D:\BaiduNetdiskDownload\graduation_project\project_folder\ansible\playbook\role_include.py,63.0
ansible.playbook.role_include.IncludeRole.load,119,3,2,1,2,0,0,37.0,1.0,0.0,D:\BaiduNetdiskDownload\graduation_project\project_folder\ansible\playbook\role_include.py,119.0
ansible.playbook.taggable.Taggable._load_tags,42,3,3,0,3,0,0,7.0,3.0,0.0,D:\BaiduNetdiskDownload\graduation_project\project_folder\ansible\playbook\taggable.py,42.0
ansible.playbook.taggable.Taggable.evaluate_tags,50,4,3,1,3,0,0,41.0,4.0,0.0,D:\BaiduNetdiskDownload\graduation_project\project_folder\ansible\playbook\taggable.py,50.0
ansible.playbook.taggable._flatten_tags,27,2,1,1,1,0,0,8.0,1.0,0.0,D:\BaiduNetdiskDownload\graduation_project\project_folder\ansible\playbook\taggable.py,27.0
ansible.playbook.task.Task.__init__,86,6,0,6,0,0,0,14.0,1.0,0.0,D:\BaiduNetdiskDownload\graduation_project\project_folder\ansible\playbook\task.py,86.0
ansible.playbook.task.Task.__repr__,136,1,1,0,1,0,0,6.0,1.0,0.0,D:\BaiduNetdiskDownload\graduation_project\project_folder\ansible\playbook\task.py,136.0
ansible.playbook.task.Task._get_parent_attribute,457,1,1,0,1,0,0,39.0,2.0,0.0,D:\BaiduNetdiskDownload\graduation_project\project_folder\ansible\playbook\task.py,457.0
ansible.playbook.task.Task._load_loop_control,251,1,1,0,1,0,0,9.0,3.0,0.0,D:\BaiduNetdiskDownload\graduation_project\project_folder\ansible\playbook\task.py,251.0
ansible.playbook.task.Task._merge_kv,117,3,3,0,3,0,0,13.0,2.0,0.0,D:\BaiduNetdiskDownload\graduation_project\project_folder\ansible\playbook\task.py,117.0
ansible.playbook.task.Task._post_validate_environment,297,1,1,0,1,0,0,40.0,4.0,0.0,D:\BaiduNetdiskDownload\graduation_project\project_folder\ansible\playbook\task.py,297.0
ansible.playbook.task.Task._preprocess_with_loop,143,2,1,1,1,0,0,10.0,5.0,0.0,D:\BaiduNetdiskDownload\graduation_project\project_folder\ansible\playbook\task.py,143.0
ansible.playbook.task.Task.all_parents_static,497,2,1,1,1,1,1,4.0,1.0,0.0,D:\BaiduNetdiskDownload\graduation_project\project_folder\ansible\playbook\task.py,497.0
ansible.playbook.task.Task.copy,381,2,1,1,1,1,1,16.0,1.0,0.0,D:\BaiduNetdiskDownload\graduation_project\project_folder\ansible\playbook\task.py,381.0
ansible.playbook.task.Task.deserialize,414,7,5,2,5,1,1,30.0,2.0,0.0,D:\BaiduNetdiskDownload\graduation_project\project_folder\ansible\playbook\task.py,414.0
ansible.playbook.task.Task.get_first_parent_include,502,2,1,1,1,1,1,7.0,1.0,0.0,D:\BaiduNetdiskDownload\graduation_project\project_folder\ansible\playbook\task.py,502.0
ansible.playbook.task.Task.get_include_params,373,2,1,1,1,1,1,7.0,1.0,0.0,D:\BaiduNetdiskDownload\graduation_project\project_folder\ansible\playbook\task.py,373.0
ansible.playbook.task.Task.get_name,101,4,1,3,1,1,1,15.0,1.0,0.0,D:\BaiduNetdiskDownload\graduation_project\project_folder\ansible\playbook\task.py,101.0
ansible.playbook.task.Task.get_play,510,1,0,1,0,0,0,5.0,1.0,0.0,D:\BaiduNetdiskDownload\graduation_project\project_folder\ansible\playbook\task.py,510.0
ansible.playbook.task.Task.get_vars,359,2,1,1,1,1,1,13.0,1.0,0.0,D:\BaiduNetdiskDownload\graduation_project\project_folder\ansible\playbook\task.py,359.0
ansible.playbook.task.Task.load,132,3,1,2,1,0,0,3.0,1.0,0.0,D:\BaiduNetdiskDownload\graduation_project\project_folder\ansible\playbook\task.py,132.0
ansible.playbook.task.Task.post_validate,276,2,1,1,1,1,1,13.0,2.0,0.0,D:\BaiduNetdiskDownload\graduation_project\project_folder\ansible\playbook\task.py,276.0
ansible.playbook.task.Task.preprocess_data,156,11,11,0,11,0,0,94.0,2.0,0.0,D:\BaiduNetdiskDownload\graduation_project\project_folder\ansible\playbook\task.py,156.0
ansible.playbook.task.Task.serialize,398,2,1,1,1,1,1,15.0,1.0,0.0,D:\BaiduNetdiskDownload\graduation_project\project_folder\ansible\playbook\task.py,398.0
ansible.playbook.task.Task.set_loader,445,5,1,4,1,1,1,11.0,2.0,0.0,D:\BaiduNetdiskDownload\graduation_project\project_folder\ansible\playbook\task.py,445.0
ansible.playbook.task_include.TaskInclude.__init__,46,3,0,3,0,0,0,3.0,1.0,0.0,D:\BaiduNetdiskDownload\graduation_project\project_folder\ansible\playbook\task_include.py,46.0
ansible.playbook.task_include.TaskInclude.build_parent_block,106,4,2,2,2,0,0,20.0,1.0,0.0,D:\BaiduNetdiskDownload\graduation_project\project_folder\ansible\playbook\task_include.py,106.0
ansible.playbook.task_include.TaskInclude.check_options,60,4,2,2,2,0,0,26.0,3.0,0.0,D:\BaiduNetdiskDownload\graduation_project\project_folder\ansible\playbook\task_include.py,60.0
ansible.playbook.task_include.TaskInclude.load,51,2,2,0,2,0,0,8.0,1.0,0.0,D:\BaiduNetdiskDownload\graduation_project\project_folder\ansible\playbook\task_include.py,51.0
ansible.playbook.task_include.TaskInclude.preprocess_data,87,1,1,0,1,0,0,13.0,2.0,0.0,D:\BaiduNetdiskDownload\graduation_project\project_folder\ansible\playbook\task_include.py,87.0
ansible.plugins.__init__.AnsibleJinja2Plugin.plugin_type,140,2,2,0,2,0,0,2.0,1.0,0.0,D:\BaiduNetdiskDownload\graduation_project\project_folder\ansible\plugins\__init__.py,140.0
ansible.plugins.__init__.AnsiblePlugin.get_option,80,9,2,7,2,0,0,6.0,2.0,0.0,D:\BaiduNetdiskDownload\graduation_project\project_folder\ansible\plugins\__init__.py,73.0
ansible.plugins.__init__.AnsiblePlugin.get_option_and_origin,73,1,0,1,0,0,0,6.0,2.0,0.0,D:\BaiduNetdiskDownload\graduation_project\project_folder\ansible\plugins\__init__.py,73.0
ansible.plugins.__init__.AnsiblePlugin.get_options,87,1,1,0,1,0,0,5.0,1.0,0.0,D:\BaiduNetdiskDownload\graduation_project\project_folder\ansible\plugins\__init__.py,87.0
ansible.plugins.__init__.AnsiblePlugin.has_option,112,1,1,0,1,0,0,4.0,2.0,0.0,D:\BaiduNetdiskDownload\graduation_project\project_folder\ansible\plugins\__init__.py,112.0
ansible.plugins.__init__.AnsiblePlugin.matches_name,63,3,2,1,2,0,0,9.0,2.0,0.0,D:\BaiduNetdiskDownload\graduation_project\project_folder\ansible\plugins\__init__.py,63.0
ansible.plugins.__init__.AnsiblePlugin.plugin_type,118,2,2,0,2,0,0,2.0,1.0,0.0,D:\BaiduNetdiskDownload\graduation_project\project_folder\ansible\plugins\__init__.py,118.0
ansible.plugins.__init__.AnsiblePlugin.set_option,93,2,0,2,0,0,0,2.0,3.0,0.0,D:\BaiduNetdiskDownload\graduation_project\project_folder\ansible\plugins\__init__.py,93.0
ansible.plugins.__init__.AnsiblePlugin.set_options,96,3,0,3,0,0,0,15.0,1.0,0.0,D:\BaiduNetdiskDownload\graduation_project\project_folder\ansible\plugins\__init__.py,96.0
ansible.plugins.__init__.get_plugin_class,44,5,2,3,2,0,0,5.0,1.0,0.0,D:\BaiduNetdiskDownload\graduation_project\project_folder\ansible\plugins\__init__.py,44.0
ansible.plugins.action.__init__.ActionBase._compute_environment_string,332,4,1,3,1,0,0,32.0,1.0,0.0,D:\BaiduNetdiskDownload\graduation_project\project_folder\ansible\plugins\action\__init__.py,332.0
ansible.plugins.action.__init__.ActionBase._configure_module,221,11,10,1,10,0,0,110.0,4.0,0.0,D:\BaiduNetdiskDownload\graduation_project\project_folder\ansible\plugins\action\__init__.py,221.0
ansible.plugins.action.__init__.ActionBase._early_needs_tmp_path,365,1,0,1,0,0,0,6.0,1.0,0.0,D:\BaiduNetdiskDownload\graduation_project\project_folder\ansible\plugins\action\__init__.py,365.0
ansible.plugins.action.__init__.ActionBase._execute_module,1004,46,28,18,28,0,0,212.0,1.0,0.0,D:\BaiduNetdiskDownload\graduation_project\project_folder\ansible\plugins\action\__init__.py,1004.0
ansible.plugins.action.__init__.ActionBase._execute_remote_stat,836,7,3,4,3,0,0,41.0,4.0,0.0,D:\BaiduNetdiskDownload\graduation_project\project_folder\ansible\plugins\action\__init__.py,836.0
ansible.plugins.action.__init__.ActionBase._find_needle,1424,9,2,7,2,0,0,12.0,3.0,0.0,D:\BaiduNetdiskDownload\graduation_project\project_folder\ansible\plugins\action\__init__.py,1424.0
ansible.plugins.action.__init__.ActionBase._fixup_perms2,585,19,13,6,13,0,0,218.0,2.0,0.0,D:\BaiduNetdiskDownload\graduation_project\project_folder\ansible\plugins\action\__init__.py,585.0
ansible.plugins.action.__init__.ActionBase._get_admin_users,402,3,1,2,1,0,0,7.0,1.0,0.0,D:\BaiduNetdiskDownload\graduation_project\project_folder\ansible\plugins\action\__init__.py,402.0
ansible.plugins.action.__init__.ActionBase._get_diff_data,1348,8,6,2,6,0,0,75.0,4.0,0.0,D:\BaiduNetdiskDownload\graduation_project\project_folder\ansible\plugins\action\__init__.py,1348.0
ansible.plugins.action.__init__.ActionBase._get_remote_addr,410,1,0,1,0,0,0,13.0,2.0,0.0,D:\BaiduNetdiskDownload\graduation_project\project_folder\ansible\plugins\action\__init__.py,410.0
ansible.plugins.action.__init__.ActionBase._get_remote_user,424,5,0,5,0,0,0,14.0,1.0,0.0,D:\BaiduNetdiskDownload\graduation_project\project_folder\ansible\plugins\action\__init__.py,424.0
ansible.plugins.action.__init__.ActionBase._is_become_unprivileged,439,6,3,3,3,0,0,16.0,1.0,0.0,D:\BaiduNetdiskDownload\graduation_project\project_folder\ansible\plugins\action\__init__.py,439.0
ansible.plugins.action.__init__.ActionBase._is_pipelining_enabled,372,1,0,1,0,0,0,29.0,2.0,0.0,D:\BaiduNetdiskDownload\graduation_project\project_folder\ansible\plugins\action\__init__.py,372.0
ansible.plugins.action.__init__.ActionBase._low_level_execute_command,1268,25,10,15,10,0,0,79.0,2.0,0.0,D:\BaiduNetdiskDownload\graduation_project\project_folder\ansible\plugins\action\__init__.py,1268.0
ansible.plugins.action.__init__.ActionBase._make_tmp_path,456,11,9,2,9,0,0,62.0,1.0,0.0,D:\BaiduNetdiskDownload\graduation_project\project_folder\ansible\plugins\action\__init__.py,456.0
ansible.plugins.action.__init__.ActionBase._parse_returned_data,1217,9,8,1,8,0,0,49.0,2.0,0.0,D:\BaiduNetdiskDownload\graduation_project\project_folder\ansible\plugins\action\__init__.py,1217.0
ansible.plugins.action.__init__.ActionBase._remote_chgrp,820,3,2,1,2,0,0,7.0,3.0,0.0,D:\BaiduNetdiskDownload\graduation_project\project_folder\ansible\plugins\action\__init__.py,820.0
ansible.plugins.action.__init__.ActionBase._remote_chmod,804,2,1,1,1,0,0,7.0,3.0,0.0,D:\BaiduNetdiskDownload\graduation_project\project_folder\ansible\plugins\action\__init__.py,804.0
ansible.plugins.action.__init__.ActionBase._remote_chown,812,2,1,1,1,0,0,7.0,3.0,0.0,D:\BaiduNetdiskDownload\graduation_project\project_folder\ansible\plugins\action\__init__.py,812.0
ansible.plugins.action.__init__.ActionBase._remote_expand_user,878,16,10,6,10,0,0,53.0,2.0,0.0,D:\BaiduNetdiskDownload\graduation_project\project_folder\ansible\plugins\action\__init__.py,878.0
ansible.plugins.action.__init__.ActionBase._remote_file_exists,214,3,1,2,1,0,0,6.0,2.0,0.0,D:\BaiduNetdiskDownload\graduation_project\project_folder\ansible\plugins\action\__init__.py,214.0
ansible.plugins.action.__init__.ActionBase._remote_set_user_facl,828,2,1,1,1,0,0,7.0,4.0,0.0,D:\BaiduNetdiskDownload\graduation_project\project_folder\ansible\plugins\action\__init__.py,828.0
ansible.plugins.action.__init__.ActionBase._remove_tmp_path,523,18,3,15,3,0,0,17.0,2.0,0.0,D:\BaiduNetdiskDownload\graduation_project\project_folder\ansible\plugins\action\__init__.py,523.0
ansible.plugins.action.__init__.ActionBase._should_remove_tmp_path,519,2,0,2,0,0,0,3.0,2.0,0.0,D:\BaiduNetdiskDownload\graduation_project\project_folder\ansible\plugins\action\__init__.py,519.0
ansible.plugins.action.__init__.ActionBase._strip_success_message,932,3,2,1,2,0,0,7.0,2.0,0.0,D:\BaiduNetdiskDownload\graduation_project\project_folder\ansible\plugins\action\__init__.py,932.0
ansible.plugins.action.__init__.ActionBase._transfer_data,559,6,5,1,5,0,0,25.0,3.0,0.0,D:\BaiduNetdiskDownload\graduation_project\project_folder\ansible\plugins\action\__init__.py,559.0
ansible.plugins.action.__init__.ActionBase._transfer_file,541,7,0,7,0,0,0,17.0,3.0,0.0,D:\BaiduNetdiskDownload\graduation_project\project_folder\ansible\plugins\action\__init__.py,541.0
ansible.plugins.action.__init__.ActionBase._update_module_args,940,4,3,1,3,0,0,63.0,4.0,0.0,D:\BaiduNetdiskDownload\graduation_project\project_folder\ansible\plugins\action\__init__.py,940.0
ansible.plugins.action.__init__.ActionBase.cleanup,184,1,1,0,1,0,0,11.0,1.0,0.0,D:\BaiduNetdiskDownload\graduation_project\project_folder\ansible\plugins\action\__init__.py,184.0
ansible.plugins.action.__init__.ActionBase.get_become_option,205,5,1,4,1,0,0,2.0,2.0,0.0,D:\BaiduNetdiskDownload\graduation_project\project_folder\ansible\plugins\action\__init__.py,205.0
ansible.plugins.action.__init__.ActionBase.get_connection_option,208,1,1,0,1,0,0,2.0,2.0,0.0,D:\BaiduNetdiskDownload\graduation_project\project_folder\ansible\plugins\action\__init__.py,208.0
ansible.plugins.action.__init__.ActionBase.get_plugin_option,196,3,0,3,0,0,0,8.0,3.0,0.0,D:\BaiduNetdiskDownload\graduation_project\project_folder\ansible\plugins\action\__init__.py,196.0
ansible.plugins.action.__init__.ActionBase.get_shell_option,211,7,1,6,1,0,0,2.0,2.0,0.0,D:\BaiduNetdiskDownload\graduation_project\project_folder\ansible\plugins\action\__init__.py,211.0
ansible.plugins.action.__init__.ActionBase.run,91,5,5,0,5,0,0,42.0,1.0,0.0,D:\BaiduNetdiskDownload\graduation_project\project_folder\ansible\plugins\action\__init__.py,91.0
ansible.plugins.action.__init__.ActionBase.validate_argument_spec,134,7,3,4,3,0,0,49.0,1.0,0.0,D:\BaiduNetdiskDownload\graduation_project\project_folder\ansible\plugins\action\__init__.py,134.0
ansible.plugins.action.__init__._validate_utf8_json,40,4,2,2,2,1,1,10.0,1.0,0.0,D:\BaiduNetdiskDownload\graduation_project\project_folder\ansible\plugins\action\__init__.py,40.0
ansible.plugins.action.add_host.ActionModule.run,41,8,8,0,8,0,0,55.0,1.0,0.0,D:\BaiduNetdiskDownload\graduation_project\project_folder\ansible\plugins\action\add_host.py,41.0
ansible.plugins.action.assemble.ActionModule._assemble_from_fragments,39,8,7,1,7,0,0,42.0,2.0,0.0,D:\BaiduNetdiskDownload\graduation_project\project_folder\ansible\plugins\action\assemble.py,39.0
ansible.plugins.action.assemble.ActionModule.run,82,12,12,0,12,0,0,84.0,1.0,0.0,D:\BaiduNetdiskDownload\graduation_project\project_folder\ansible\plugins\action\assemble.py,82.0
ansible.plugins.action.assert.ActionModule.run,33,4,4,0,4,0,0,62.0,1.0,0.0,D:\BaiduNetdiskDownload\graduation_project\project_folder\ansible\plugins\action\assert.py,33.0
ansible.plugins.action.async_status.ActionModule._get_async_dir,12,3,2,1,2,0,0,6.0,1.0,0.0,D:\BaiduNetdiskDownload\graduation_project\project_folder\ansible\plugins\action\async_status.py,12.0
ansible.plugins.action.async_status.ActionModule.run,19,4,4,0,4,0,0,33.0,1.0,0.0,D:\BaiduNetdiskDownload\graduation_project\project_folder\ansible\plugins\action\async_status.py,19.0
ansible.plugins.action.command.ActionModule.run,12,3,3,0,3,0,0,15.0,1.0,0.0,D:\BaiduNetdiskDownload\graduation_project\project_folder\ansible\plugins\action\command.py,12.0
ansible.plugins.action.copy.ActionModule._copy_file,229,13,12,1,12,0,0,161.0,8.0,0.0,D:\BaiduNetdiskDownload\graduation_project\project_folder\ansible\plugins\action\copy.py,229.0
ansible.plugins.action.copy.ActionModule._create_content_tempfile,391,3,2,1,2,0,0,13.0,2.0,0.0,D:\BaiduNetdiskDownload\graduation_project\project_folder\ansible\plugins\action\copy.py,391.0
ansible.plugins.action.copy.ActionModule._ensure_invocation,206,1,0,1,0,0,0,22.0,2.0,0.0,D:\BaiduNetdiskDownload\graduation_project\project_folder\ansible\plugins\action\copy.py,206.0
ansible.plugins.action.copy.ActionModule._remove_tempfile_if_content_defined,405,1,0,1,0,0,0,3.0,3.0,0.0,D:\BaiduNetdiskDownload\graduation_project\project_folder\ansible\plugins\action\copy.py,405.0
ansible.plugins.action.copy.ActionModule.run,409,15,15,0,15,0,0,194.0,1.0,0.0,D:\BaiduNetdiskDownload\graduation_project\project_folder\ansible\plugins\action\copy.py,409.0
ansible.plugins.action.copy._create_remote_copy_args,48,2,1,1,1,0,0,3.0,1.0,0.0,D:\BaiduNetdiskDownload\graduation_project\project_folder\ansible\plugins\action\copy.py,48.0
ansible.plugins.action.copy._create_remote_file_args,43,3,1,2,1,0,0,3.0,1.0,0.0,D:\BaiduNetdiskDownload\graduation_project\project_folder\ansible\plugins\action\copy.py,43.0
ansible.plugins.action.copy._walk_dirs,53,7,6,1,6,0,0,147.0,1.0,2.0,D:\BaiduNetdiskDownload\graduation_project\project_folder\ansible\plugins\action\copy.py,53.0
ansible.plugins.action.debug.ActionModule.run,33,2,2,0,2,0,0,53.0,1.0,0.0,D:\BaiduNetdiskDownload\graduation_project\project_folder\ansible\plugins\action\debug.py,33.0
ansible.plugins.action.dnf.ActionModule.run,18,6,6,0,6,0,0,66.0,1.0,0.0,D:\BaiduNetdiskDownload\graduation_project\project_folder\ansible\plugins\action\dnf.py,18.0
ansible.plugins.action.fetch.ActionModule.run,35,19,19,0,19,0,0,178.0,1.0,0.0,D:\BaiduNetdiskDownload\graduation_project\project_folder\ansible\plugins\action\fetch.py,35.0
ansible.plugins.action.gather_facts.ActionModule._combine_task_result,63,2,1,1,1,0,0,9.0,5.0,0.0,D:\BaiduNetdiskDownload\graduation_project\project_folder\ansible\plugins\action\gather_facts.py,63.0
ansible.plugins.action.gather_facts.ActionModule._get_module_args,21,7,6,1,6,0,0,41.0,4.0,0.0,D:\BaiduNetdiskDownload\graduation_project\project_folder\ansible\plugins\action\gather_facts.py,21.0
ansible.plugins.action.gather_facts.ActionModule.run,73,10,10,0,10,0,0,103.0,2.0,0.0,D:\BaiduNetdiskDownload\graduation_project\project_folder\ansible\plugins\action\gather_facts.py,73.0
ansible.plugins.action.group_by.ActionModule.run,31,1,1,0,1,0,0,21.0,1.0,0.0,D:\BaiduNetdiskDownload\graduation_project\project_folder\ansible\plugins\action\group_by.py,31.0
ansible.plugins.action.include_vars.ActionModule._ignore_file,195,3,2,1,2,0,0,16.0,2.0,0.0,D:\BaiduNetdiskDownload\graduation_project\project_folder\ansible\plugins\action\include_vars.py,195.0
ansible.plugins.action.include_vars.ActionModule._is_valid_file_ext,212,2,0,2,0,0,0,9.0,2.0,0.0,D:\BaiduNetdiskDownload\graduation_project\project_folder\ansible\plugins\action\include_vars.py,212.0
ansible.plugins.action.include_vars.ActionModule._load_files,222,8,6,2,6,0,0,30.0,2.0,0.0,D:\BaiduNetdiskDownload\graduation_project\project_folder\ansible\plugins\action\include_vars.py,222.0
ansible.plugins.action.include_vars.ActionModule._load_files_in_dir,253,5,4,1,4,0,0,38.0,3.0,0.0,D:\BaiduNetdiskDownload\graduation_project\project_folder\ansible\plugins\action\include_vars.py,253.0
ansible.plugins.action.include_vars.ActionModule._log_walk,177,1,1,0,1,0,0,2.0,2.0,0.0,D:\BaiduNetdiskDownload\graduation_project\project_folder\ansible\plugins\action\include_vars.py,177.0
ansible.plugins.action.include_vars.ActionModule._set_args,49,3,2,1,2,0,0,23.0,1.0,0.0,D:\BaiduNetdiskDownload\graduation_project\project_folder\ansible\plugins\action\include_vars.py,49.0
ansible.plugins.action.include_vars.ActionModule._set_dir_defaults,28,3,2,1,2,0,0,20.0,1.0,0.0,D:\BaiduNetdiskDownload\graduation_project\project_folder\ansible\plugins\action\include_vars.py,28.0
ansible.plugins.action.include_vars.ActionModule._set_root_dir,155,3,2,1,2,0,0,21.0,1.0,0.0,D:\BaiduNetdiskDownload\graduation_project\project_folder\ansible\plugins\action\include_vars.py,155.0
ansible.plugins.action.include_vars.ActionModule._traverse_dir_depth,180,1,0,1,0,0,0,14.0,1.0,0.0,D:\BaiduNetdiskDownload\graduation_project\project_folder\ansible\plugins\action\include_vars.py,180.0
ansible.plugins.action.include_vars.ActionModule.run,73,11,11,0,11,0,0,81.0,1.0,0.0,D:\BaiduNetdiskDownload\graduation_project\project_folder\ansible\plugins\action\include_vars.py,73.0
ansible.plugins.action.normal.ActionModule.run,29,3,3,0,3,0,0,21.0,1.0,0.0,D:\BaiduNetdiskDownload\graduation_project\project_folder\ansible\plugins\action\normal.py,29.0
ansible.plugins.action.package.ActionModule.run,35,8,8,0,8,0,0,77.0,1.0,0.0,D:\BaiduNetdiskDownload\graduation_project\project_folder\ansible\plugins\action\package.py,35.0
ansible.plugins.action.pause.ActionModule.run,35,7,7,0,7,0,0,113.0,1.0,0.0,D:\BaiduNetdiskDownload\graduation_project\project_folder\ansible\plugins\action\pause.py,35.0
ansible.plugins.action.raw.ActionModule.run,25,2,2,0,2,0,0,25.0,1.0,0.0,D:\BaiduNetdiskDownload\graduation_project\project_folder\ansible\plugins\action\raw.py,25.0
ansible.plugins.action.reboot.ActionModule._check_delay,96,2,0,2,0,0,0,6.0,3.0,0.0,D:\BaiduNetdiskDownload\graduation_project\project_folder\ansible\plugins\action\reboot.py,96.0
ansible.plugins.action.reboot.ActionModule._get_value_from_facts,103,4,0,4,0,0,0,11.0,4.0,0.0,D:\BaiduNetdiskDownload\graduation_project\project_folder\ansible\plugins\action\reboot.py,103.0
ansible.plugins.action.reboot.ActionModule.check_boot_time,234,5,5,0,5,0,0,27.0,3.0,0.0,D:\BaiduNetdiskDownload\graduation_project\project_folder\ansible\plugins\action\reboot.py,234.0
ansible.plugins.action.reboot.ActionModule.deprecated_args,202,4,3,1,3,0,0,7.0,1.0,0.0,D:\BaiduNetdiskDownload\graduation_project\project_folder\ansible\plugins\action\reboot.py,202.0
ansible.plugins.action.reboot.ActionModule.do_until_success_or_timeout,285,6,5,1,5,0,0,45.0,5.0,0.0,D:\BaiduNetdiskDownload\graduation_project\project_folder\ansible\plugins\action\reboot.py,285.0
ansible.plugins.action.reboot.ActionModule.get_distribution,136,9,8,1,8,0,0,20.0,2.0,0.0,D:\BaiduNetdiskDownload\graduation_project\project_folder\ansible\plugins\action\reboot.py,136.0
ansible.plugins.action.reboot.ActionModule.get_shutdown_command,157,9,8,1,8,0,0,20.0,2.0,0.0,D:\BaiduNetdiskDownload\graduation_project\project_folder\ansible\plugins\action\reboot.py,115.0
ansible.plugins.action.reboot.ActionModule.get_shutdown_command_args,115,6,5,1,5,0,0,20.0,2.0,0.0,D:\BaiduNetdiskDownload\graduation_project\project_folder\ansible\plugins\action\reboot.py,115.0
ansible.plugins.action.reboot.ActionModule.get_system_boot_time,210,9,7,2,7,0,0,23.0,2.0,0.0,D:\BaiduNetdiskDownload\graduation_project\project_folder\ansible\plugins\action\reboot.py,210.0
ansible.plugins.action.reboot.ActionModule.perform_reboot,331,9,8,1,8,0,0,28.0,3.0,0.0,D:\BaiduNetdiskDownload\graduation_project\project_folder\ansible\plugins\action\reboot.py,331.0
ansible.plugins.action.reboot.ActionModule.post_reboot_delay,93,1,1,0,1,0,0,2.0,1.0,0.0,D:\BaiduNetdiskDownload\graduation_project\project_folder\ansible\plugins\action\reboot.py,93.0
ansible.plugins.action.reboot.ActionModule.pre_reboot_delay,89,1,1,0,1,0,0,2.0,1.0,0.0,D:\BaiduNetdiskDownload\graduation_project\project_folder\ansible\plugins\action\reboot.py,89.0
ansible.plugins.action.reboot.ActionModule.run,421,9,9,0,9,0,0,22.0,3.0,0.0,D:\BaiduNetdiskDownload\graduation_project\project_folder\ansible\plugins\action\reboot.py,262.0
ansible.plugins.action.reboot.ActionModule.run_test_command,262,5,5,0,5,0,0,22.0,3.0,0.0,D:\BaiduNetdiskDownload\graduation_project\project_folder\ansible\plugins\action\reboot.py,262.0
ansible.plugins.action.reboot.ActionModule.validate_reboot,360,6,5,1,5,0,0,60.0,2.0,0.0,D:\BaiduNetdiskDownload\graduation_project\project_folder\ansible\plugins\action\reboot.py,360.0
ansible.plugins.action.script.ActionModule.run,37,19,19,0,19,0,0,138.0,1.0,0.0,D:\BaiduNetdiskDownload\graduation_project\project_folder\ansible\plugins\action\script.py,37.0
ansible.plugins.action.service.ActionModule.run,37,9,9,0,9,0,0,66.0,1.0,0.0,D:\BaiduNetdiskDownload\graduation_project\project_folder\ansible\plugins\action\service.py,37.0
ansible.plugins.action.set_fact.ActionModule.run,34,5,5,0,5,0,0,35.0,1.0,0.0,D:\BaiduNetdiskDownload\graduation_project\project_folder\ansible\plugins\action\set_fact.py,34.0
ansible.plugins.action.set_stats.ActionModule.run,32,2,2,0,2,0,0,45.0,1.0,0.0,D:\BaiduNetdiskDownload\graduation_project\project_folder\ansible\plugins\action\set_stats.py,32.0
ansible.plugins.action.shell.ActionModule.run,12,1,1,0,1,0,0,21.0,1.0,0.0,D:\BaiduNetdiskDownload\graduation_project\project_folder\ansible\plugins\action\shell.py,12.0
ansible.plugins.action.template.ActionModule.run,36,17,17,0,17,0,0,165.0,1.0,0.0,D:\BaiduNetdiskDownload\graduation_project\project_folder\ansible\plugins\action\template.py,36.0
ansible.plugins.action.unarchive.ActionModule.run,32,14,14,0,14,0,0,79.0,1.0,0.0,D:\BaiduNetdiskDownload\graduation_project\project_folder\ansible\plugins\action\unarchive.py,32.0
ansible.plugins.action.uri.ActionModule.run,21,8,8,0,8,0,0,72.0,1.0,0.0,D:\BaiduNetdiskDownload\graduation_project\project_folder\ansible\plugins\action\uri.py,21.0
ansible.plugins.action.validate_argument_spec.ActionModule.get_args_from_task_vars,18,2,1,1,1,0,0,18.0,3.0,0.0,D:\BaiduNetdiskDownload\graduation_project\project_folder\ansible\plugins\action\validate_argument_spec.py,18.0
ansible.plugins.action.validate_argument_spec.ActionModule.run,37,6,6,0,6,0,0,56.0,1.0,0.0,D:\BaiduNetdiskDownload\graduation_project\project_folder\ansible\plugins\action\validate_argument_spec.py,37.0
ansible.plugins.action.wait_for_connection.ActionModule.do_until_success_or_timeout,44,2,1,1,1,0,0,17.0,5.0,0.0,D:\BaiduNetdiskDownload\graduation_project\project_folder\ansible\plugins\action\wait_for_connection.py,44.0
ansible.plugins.action.wait_for_connection.ActionModule.run,62,6,6,0,6,0,0,58.0,1.0,2.0,D:\BaiduNetdiskDownload\graduation_project\project_folder\ansible\plugins\action\wait_for_connection.py,62.0
ansible.plugins.become.__init__.BecomeBase._build_success_command,62,3,1,2,1,0,0,13.0,3.0,0.0,D:\BaiduNetdiskDownload\graduation_project\project_folder\ansible\plugins\become\__init__.py,62.0
ansible.plugins.become.__init__.BecomeBase._check_password_error,92,3,1,2,1,0,0,4.0,3.0,0.0,D:\BaiduNetdiskDownload\graduation_project\project_folder\ansible\plugins\become\__init__.py,92.0
ansible.plugins.become.__init__.BecomeBase.build_become_command,77,1,1,0,1,0,0,3.0,3.0,0.0,D:\BaiduNetdiskDownload\graduation_project\project_folder\ansible\plugins\become\__init__.py,77.0
ansible.plugins.become.__init__.BecomeBase.check_incorrect_password,97,2,1,1,1,0,0,5.0,2.0,0.0,D:\BaiduNetdiskDownload\graduation_project\project_folder\ansible\plugins\become\__init__.py,97.0
ansible.plugins.become.__init__.BecomeBase.check_missing_password,103,2,1,1,1,0,0,5.0,2.0,0.0,D:\BaiduNetdiskDownload\graduation_project\project_folder\ansible\plugins\become\__init__.py,103.0
ansible.plugins.become.__init__.BecomeBase.check_password_prompt,85,4,4,0,4,0,0,6.0,2.0,0.0,D:\BaiduNetdiskDownload\graduation_project\project_folder\ansible\plugins\become\__init__.py,85.0
ansible.plugins.become.__init__.BecomeBase.check_success,81,6,3,3,3,0,0,3.0,2.0,0.0,D:\BaiduNetdiskDownload\graduation_project\project_folder\ansible\plugins\become\__init__.py,81.0
ansible.plugins.become.__init__.BecomeBase.expect_prompt,56,4,1,3,1,0,0,5.0,1.0,0.0,D:\BaiduNetdiskDownload\graduation_project\project_folder\ansible\plugins\become\__init__.py,56.0
ansible.plugins.become.__init__.BecomeBase.get_option,43,4,0,4,0,0,0,12.0,2.0,0.0,D:\BaiduNetdiskDownload\graduation_project\project_folder\ansible\plugins\become\__init__.py,43.0
ansible.plugins.become.__init__._gen_id,18,2,1,1,1,0,0,3.0,0.0,0.0,D:\BaiduNetdiskDownload\graduation_project\project_folder\ansible\plugins\become\__init__.py,18.0
ansible.plugins.become.su.BecomeModule.build_become_command,152,2,2,0,2,0,0,16.0,3.0,0.0,D:\BaiduNetdiskDownload\graduation_project\project_folder\ansible\plugins\become\su.py,152.0
ansible.plugins.become.su.BecomeModule.check_password_prompt,142,4,4,0,4,0,0,9.0,2.0,0.0,D:\BaiduNetdiskDownload\graduation_project\project_folder\ansible\plugins\become\su.py,142.0
ansible.plugins.become.sudo.BecomeModule.build_become_command,91,6,6,0,6,0,0,30.0,3.0,0.0,D:\BaiduNetdiskDownload\graduation_project\project_folder\ansible\plugins\become\sudo.py,91.0
ansible.plugins.cache.__init__.BaseCacheModule.__init__,46,1,1,0,1,0,0,3.0,3.0,0.0,D:\BaiduNetdiskDownload\graduation_project\project_folder\ansible\plugins\cache\__init__.py,46.0
ansible.plugins.cache.__init__.BaseFileCacheModule.__init__,83,3,3,0,3,0,0,12.0,3.0,0.0,D:\BaiduNetdiskDownload\graduation_project\project_folder\ansible\plugins\cache\__init__.py,83.0
ansible.plugins.cache.__init__.BaseFileCacheModule._dump,274,1,0,1,0,0,0,8.0,3.0,0.0,D:\BaiduNetdiskDownload\graduation_project\project_folder\ansible\plugins\cache\__init__.py,274.0
ansible.plugins.cache.__init__.BaseFileCacheModule._get_cache_connection,96,1,0,1,0,0,0,6.0,2.0,0.0,D:\BaiduNetdiskDownload\graduation_project\project_folder\ansible\plugins\cache\__init__.py,96.0
ansible.plugins.cache.__init__.BaseFileCacheModule._get_cache_file_name,119,5,0,5,0,0,0,7.0,2.0,0.0,D:\BaiduNetdiskDownload\graduation_project\project_folder\ansible\plugins\cache\__init__.py,119.0
ansible.plugins.cache.__init__.BaseFileCacheModule._load,255,1,0,1,0,0,0,17.0,2.0,0.0,D:\BaiduNetdiskDownload\graduation_project\project_folder\ansible\plugins\cache\__init__.py,255.0
ansible.plugins.cache.__init__.BaseFileCacheModule.contains,216,4,4,0,4,0,0,16.0,2.0,0.0,D:\BaiduNetdiskDownload\graduation_project\project_folder\ansible\plugins\cache\__init__.py,216.0
ansible.plugins.cache.__init__.BaseFileCacheModule.copy,248,2,2,0,2,0,0,5.0,1.0,0.0,D:\BaiduNetdiskDownload\graduation_project\project_folder\ansible\plugins\cache\__init__.py,248.0
ansible.plugins.cache.__init__.BaseFileCacheModule.delete,233,3,1,2,1,0,0,9.0,2.0,0.0,D:\BaiduNetdiskDownload\graduation_project\project_folder\ansible\plugins\cache\__init__.py,233.0
ansible.plugins.cache.__init__.BaseFileCacheModule.flush,243,2,2,0,2,0,0,4.0,1.0,0.0,D:\BaiduNetdiskDownload\graduation_project\project_folder\ansible\plugins\cache\__init__.py,243.0
ansible.plugins.cache.__init__.BaseFileCacheModule.get,127,10,8,2,8,1,1,27.0,2.0,0.0,D:\BaiduNetdiskDownload\graduation_project\project_folder\ansible\plugins\cache\__init__.py,127.0
ansible.plugins.cache.__init__.BaseFileCacheModule.has_expired,177,6,3,3,3,0,0,21.0,2.0,0.0,D:\BaiduNetdiskDownload\graduation_project\project_folder\ansible\plugins\cache\__init__.py,177.0
ansible.plugins.cache.__init__.BaseFileCacheModule.keys,199,5,3,2,3,0,0,16.0,1.0,0.0,D:\BaiduNetdiskDownload\graduation_project\project_folder\ansible\plugins\cache\__init__.py,199.0
ansible.plugins.cache.__init__.BaseFileCacheModule.set,155,4,4,0,4,0,0,21.0,3.0,0.0,D:\BaiduNetdiskDownload\graduation_project\project_folder\ansible\plugins\cache\__init__.py,155.0
ansible.plugins.cache.__init__.BaseFileCacheModule.validate_cache_connection,103,3,2,1,2,0,0,15.0,1.0,0.0,D:\BaiduNetdiskDownload\graduation_project\project_folder\ansible\plugins\cache\__init__.py,103.0
ansible.plugins.cache.__init__.CachePluginAdjudicator.__getitem__,331,2,2,0,2,0,0,9.0,2.0,0.0,D:\BaiduNetdiskDownload\graduation_project\project_folder\ansible\plugins\cache\__init__.py,331.0
ansible.plugins.cache.__init__.CachePluginAdjudicator.__init__,288,1,1,0,1,0,0,9.0,2.0,0.0,D:\BaiduNetdiskDownload\graduation_project\project_folder\ansible\plugins\cache\__init__.py,288.0
ansible.plugins.cache.__init__.CachePluginAdjudicator.__iter__,314,1,1,0,1,0,0,2.0,1.0,0.0,D:\BaiduNetdiskDownload\graduation_project\project_folder\ansible\plugins\cache\__init__.py,314.0
ansible.plugins.cache.__init__.CachePluginAdjudicator.__len__,317,1,1,0,1,0,0,2.0,1.0,0.0,D:\BaiduNetdiskDownload\graduation_project\project_folder\ansible\plugins\cache\__init__.py,317.0
ansible.plugins.cache.__init__.CachePluginAdjudicator.__repr__,311,1,1,0,1,0,0,2.0,1.0,0.0,D:\BaiduNetdiskDownload\graduation_project\project_folder\ansible\plugins\cache\__init__.py,311.0
ansible.plugins.cache.__init__.CachePluginAdjudicator._do_load_key,320,2,0,2,0,0,0,10.0,2.0,0.0,D:\BaiduNetdiskDownload\graduation_project\project_folder\ansible\plugins\cache\__init__.py,320.0
ansible.plugins.cache.__init__.CachePluginAdjudicator.flush,371,2,1,1,1,1,1,3.0,1.0,0.0,D:\BaiduNetdiskDownload\graduation_project\project_folder\ansible\plugins\cache\__init__.py,371.0
ansible.plugins.cache.__init__.CachePluginAdjudicator.get,341,5,2,3,2,1,1,9.0,2.0,0.0,D:\BaiduNetdiskDownload\graduation_project\project_folder\ansible\plugins\cache\__init__.py,341.0
ansible.plugins.cache.__init__.CachePluginAdjudicator.items,351,127,1,126,1,1,1,2.0,1.0,0.0,D:\BaiduNetdiskDownload\graduation_project\project_folder\ansible\plugins\cache\__init__.py,351.0
ansible.plugins.cache.__init__.CachePluginAdjudicator.keys,357,6,1,5,1,1,1,2.0,1.0,0.0,D:\BaiduNetdiskDownload\graduation_project\project_folder\ansible\plugins\cache\__init__.py,357.0
ansible.plugins.cache.__init__.CachePluginAdjudicator.load_whole_cache,307,2,2,0,2,0,0,3.0,1.0,0.0,D:\BaiduNetdiskDownload\graduation_project\project_folder\ansible\plugins\cache\__init__.py,307.0
ansible.plugins.cache.__init__.CachePluginAdjudicator.pop,360,67,1,66,1,1,1,4.0,3.0,0.0,D:\BaiduNetdiskDownload\graduation_project\project_folder\ansible\plugins\cache\__init__.py,360.0
ansible.plugins.cache.__init__.CachePluginAdjudicator.set_cache,302,3,1,2,1,0,0,4.0,1.0,0.0,D:\BaiduNetdiskDownload\graduation_project\project_folder\ansible\plugins\cache\__init__.py,302.0
ansible.plugins.cache.__init__.CachePluginAdjudicator.update,375,2,1,1,1,1,1,3.0,1.0,0.0,D:\BaiduNetdiskDownload\graduation_project\project_folder\ansible\plugins\cache\__init__.py,298.0
ansible.plugins.cache.__init__.CachePluginAdjudicator.update_cache_if_changed,298,1,1,0,1,0,0,3.0,1.0,0.0,D:\BaiduNetdiskDownload\graduation_project\project_folder\ansible\plugins\cache\__init__.py,298.0
ansible.plugins.cache.__init__.CachePluginAdjudicator.values,354,21,1,20,1,1,1,2.0,1.0,0.0,D:\BaiduNetdiskDownload\graduation_project\project_folder\ansible\plugins\cache\__init__.py,354.0
ansible.plugins.cache.jsonfile.CacheModule._dump,60,1,1,0,1,0,0,3.0,3.0,0.0,D:\BaiduNetdiskDownload\graduation_project\project_folder\ansible\plugins\cache\jsonfile.py,60.0
ansible.plugins.cache.memory.CacheModule.__getstate__,48,1,1,0,1,0,0,2.0,1.0,0.0,D:\BaiduNetdiskDownload\graduation_project\project_folder\ansible\plugins\cache\memory.py,48.0
ansible.plugins.cache.memory.CacheModule.copy,45,3,1,2,1,1,1,2.0,1.0,0.0,D:\BaiduNetdiskDownload\graduation_project\project_folder\ansible\plugins\cache\memory.py,45.0
ansible.plugins.cache.memory.CacheModule.get,27,2,1,1,1,1,1,2.0,2.0,0.0,D:\BaiduNetdiskDownload\graduation_project\project_folder\ansible\plugins\cache\memory.py,27.0
ansible.plugins.cache.memory.CacheModule.keys,33,2,1,1,1,1,1,2.0,1.0,0.0,D:\BaiduNetdiskDownload\graduation_project\project_folder\ansible\plugins\cache\memory.py,33.0
ansible.plugins.callback.__init__.CallbackBase.__init__,143,2,2,0,2,0,0,20.0,1.0,0.0,D:\BaiduNetdiskDownload\graduation_project\project_folder\ansible\plugins\callback\__init__.py,143.0
ansible.plugins.callback.__init__.CallbackBase._clean_results,414,9,2,7,2,0,0,14.0,3.0,0.0,D:\BaiduNetdiskDownload\graduation_project\project_folder\ansible\plugins\callback\__init__.py,414.0
ansible.plugins.callback.__init__.CallbackBase._dump_results,200,21,5,16,5,0,0,83.0,2.0,0.0,D:\BaiduNetdiskDownload\graduation_project\project_folder\ansible\plugins\callback\__init__.py,200.0
ansible.plugins.callback.__init__.CallbackBase._get_diff,342,9,7,2,7,0,0,59.0,2.0,0.0,D:\BaiduNetdiskDownload\graduation_project\project_folder\ansible\plugins\callback\__init__.py,342.0
ansible.plugins.callback.__init__.CallbackBase._get_item_label,402,5,0,5,0,0,0,7.0,2.0,0.0,D:\BaiduNetdiskDownload\graduation_project\project_folder\ansible\plugins\callback\__init__.py,402.0
ansible.plugins.callback.__init__.CallbackBase._handle_exception,296,7,4,3,4,0,0,14.0,2.0,0.0,D:\BaiduNetdiskDownload\graduation_project\project_folder\ansible\plugins\callback\__init__.py,296.0
ansible.plugins.callback.__init__.CallbackBase._handle_warnings,284,7,2,5,2,0,0,11.0,2.0,0.0,D:\BaiduNetdiskDownload\graduation_project\project_folder\ansible\plugins\callback\__init__.py,284.0
ansible.plugins.callback.__init__.CallbackBase._print_task_path,429,4,2,2,2,0,0,4.0,2.0,0.0,D:\BaiduNetdiskDownload\graduation_project\project_folder\ansible\plugins\callback\__init__.py,429.0
ansible.plugins.callback.__init__.CallbackBase._process_items,410,3,0,3,0,0,0,3.0,2.0,0.0,D:\BaiduNetdiskDownload\graduation_project\project_folder\ansible\plugins\callback\__init__.py,410.0
ansible.plugins.callback.__init__.CallbackBase._run_is_verbose,196,5,0,5,0,0,0,3.0,2.0,0.0,D:\BaiduNetdiskDownload\graduation_project\project_folder\ansible\plugins\callback\__init__.py,196.0
ansible.plugins.callback.__init__.CallbackBase._serialize_diff,311,3,2,1,2,0,0,30.0,2.0,0.0,D:\BaiduNetdiskDownload\graduation_project\project_folder\ansible\plugins\callback\__init__.py,311.0
ansible.plugins.callback.__init__.CallbackBase.get_option,170,16,0,16,0,0,0,2.0,2.0,0.0,D:\BaiduNetdiskDownload\graduation_project\project_folder\ansible\plugins\callback\__init__.py,170.0
ansible.plugins.callback.__init__.CallbackBase.host_label,182,6,0,6,0,0,0,13.0,1.0,0.0,D:\BaiduNetdiskDownload\graduation_project\project_folder\ansible\plugins\callback\__init__.py,182.0
ansible.plugins.callback.__init__.CallbackBase.on_any,437,1,0,1,0,0,0,2.0,3.0,0.0,D:\BaiduNetdiskDownload\graduation_project\project_folder\ansible\plugins\callback\__init__.py,437.0
ansible.plugins.callback.__init__.CallbackBase.on_file_diff,497,1,0,1,0,0,0,2.0,3.0,0.0,D:\BaiduNetdiskDownload\graduation_project\project_folder\ansible\plugins\callback\__init__.py,497.0
ansible.plugins.callback.__init__.CallbackBase.playbook_on_import_for_host,485,1,0,1,0,0,0,2.0,3.0,0.0,D:\BaiduNetdiskDownload\graduation_project\project_folder\ansible\plugins\callback\__init__.py,485.0
ansible.plugins.callback.__init__.CallbackBase.playbook_on_no_hosts_matched,470,1,0,1,0,0,0,2.0,1.0,0.0,D:\BaiduNetdiskDownload\graduation_project\project_folder\ansible\plugins\callback\__init__.py,470.0
ansible.plugins.callback.__init__.CallbackBase.playbook_on_no_hosts_remaining,473,1,0,1,0,0,0,2.0,1.0,0.0,D:\BaiduNetdiskDownload\graduation_project\project_folder\ansible\plugins\callback\__init__.py,473.0
ansible.plugins.callback.__init__.CallbackBase.playbook_on_not_import_for_host,488,1,0,1,0,0,0,2.0,3.0,0.0,D:\BaiduNetdiskDownload\graduation_project\project_folder\ansible\plugins\callback\__init__.py,488.0
ansible.plugins.callback.__init__.CallbackBase.playbook_on_notify,467,1,0,1,0,0,0,2.0,3.0,0.0,D:\BaiduNetdiskDownload\graduation_project\project_folder\ansible\plugins\callback\__init__.py,467.0
ansible.plugins.callback.__init__.CallbackBase.playbook_on_play_start,491,1,0,1,0,0,0,2.0,2.0,0.0,D:\BaiduNetdiskDownload\graduation_project\project_folder\ansible\plugins\callback\__init__.py,491.0
ansible.plugins.callback.__init__.CallbackBase.playbook_on_start,464,1,0,1,0,0,0,2.0,1.0,0.0,D:\BaiduNetdiskDownload\graduation_project\project_folder\ansible\plugins\callback\__init__.py,464.0
ansible.plugins.callback.__init__.CallbackBase.playbook_on_stats,494,1,0,1,0,0,0,2.0,2.0,0.0,D:\BaiduNetdiskDownload\graduation_project\project_folder\ansible\plugins\callback\__init__.py,494.0
ansible.plugins.callback.__init__.CallbackBase.playbook_on_task_start,476,1,0,1,0,0,0,2.0,3.0,0.0,D:\BaiduNetdiskDownload\graduation_project\project_folder\ansible\plugins\callback\__init__.py,476.0
ansible.plugins.callback.__init__.CallbackBase.playbook_on_vars_prompt,479,1,0,1,0,0,0,2.0,2.0,0.0,D:\BaiduNetdiskDownload\graduation_project\project_folder\ansible\plugins\callback\__init__.py,479.0
ansible.plugins.callback.__init__.CallbackBase.runner_on_async_failed,461,1,0,1,0,0,0,2.0,4.0,0.0,D:\BaiduNetdiskDownload\graduation_project\project_folder\ansible\plugins\callback\__init__.py,461.0
ansible.plugins.callback.__init__.CallbackBase.runner_on_async_ok,458,1,0,1,0,0,0,2.0,4.0,0.0,D:\BaiduNetdiskDownload\graduation_project\project_folder\ansible\plugins\callback\__init__.py,458.0
ansible.plugins.callback.__init__.CallbackBase.runner_on_async_poll,455,1,0,1,0,0,0,2.0,5.0,0.0,D:\BaiduNetdiskDownload\graduation_project\project_folder\ansible\plugins\callback\__init__.py,455.0
ansible.plugins.callback.__init__.CallbackBase.runner_on_failed,440,1,0,1,0,0,0,2.0,3.0,0.0,D:\BaiduNetdiskDownload\graduation_project\project_folder\ansible\plugins\callback\__init__.py,440.0
ansible.plugins.callback.__init__.CallbackBase.runner_on_ok,443,1,0,1,0,0,0,2.0,3.0,0.0,D:\BaiduNetdiskDownload\graduation_project\project_folder\ansible\plugins\callback\__init__.py,443.0
ansible.plugins.callback.__init__.CallbackBase.runner_on_skipped,446,1,0,1,0,0,0,2.0,2.0,0.0,D:\BaiduNetdiskDownload\graduation_project\project_folder\ansible\plugins\callback\__init__.py,446.0
ansible.plugins.callback.__init__.CallbackBase.runner_on_unreachable,449,1,0,1,0,0,0,2.0,3.0,0.0,D:\BaiduNetdiskDownload\graduation_project\project_folder\ansible\plugins\callback\__init__.py,449.0
ansible.plugins.callback.__init__.CallbackBase.set_options,173,1,0,1,0,0,0,7.0,1.0,0.0,D:\BaiduNetdiskDownload\graduation_project\project_folder\ansible\plugins\callback\__init__.py,173.0
ansible.plugins.callback.__init__.CallbackBase.set_play_context,434,1,0,1,0,0,0,2.0,2.0,0.0,D:\BaiduNetdiskDownload\graduation_project\project_folder\ansible\plugins\callback\__init__.py,434.0
ansible.plugins.callback.__init__.CallbackBase.v2_on_any,501,1,1,0,1,0,0,2.0,3.0,0.0,D:\BaiduNetdiskDownload\graduation_project\project_folder\ansible\plugins\callback\__init__.py,501.0
ansible.plugins.callback.__init__.CallbackBase.v2_on_file_diff,583,1,1,0,1,0,0,4.0,2.0,0.0,D:\BaiduNetdiskDownload\graduation_project\project_folder\ansible\plugins\callback\__init__.py,583.0
ansible.plugins.callback.__init__.CallbackBase.v2_playbook_on_import_for_host,568,1,1,0,1,0,0,3.0,3.0,0.0,D:\BaiduNetdiskDownload\graduation_project\project_folder\ansible\plugins\callback\__init__.py,568.0
ansible.plugins.callback.__init__.CallbackBase.v2_playbook_on_no_hosts_matched,548,1,1,0,1,0,0,2.0,1.0,0.0,D:\BaiduNetdiskDownload\graduation_project\project_folder\ansible\plugins\callback\__init__.py,548.0
ansible.plugins.callback.__init__.CallbackBase.v2_playbook_on_no_hosts_remaining,551,1,1,0,1,0,0,2.0,1.0,0.0,D:\BaiduNetdiskDownload\graduation_project\project_folder\ansible\plugins\callback\__init__.py,551.0
ansible.plugins.callback.__init__.CallbackBase.v2_playbook_on_not_import_for_host,573,1,1,0,1,0,0,3.0,3.0,0.0,D:\BaiduNetdiskDownload\graduation_project\project_folder\ansible\plugins\callback\__init__.py,573.0
ansible.plugins.callback.__init__.CallbackBase.v2_playbook_on_notify,545,1,1,0,1,0,0,2.0,3.0,0.0,D:\BaiduNetdiskDownload\graduation_project\project_folder\ansible\plugins\callback\__init__.py,545.0
ansible.plugins.callback.__init__.CallbackBase.v2_playbook_on_play_start,577,1,1,0,1,0,0,2.0,2.0,0.0,D:\BaiduNetdiskDownload\graduation_project\project_folder\ansible\plugins\callback\__init__.py,577.0
ansible.plugins.callback.__init__.CallbackBase.v2_playbook_on_start,542,1,1,0,1,0,0,2.0,2.0,0.0,D:\BaiduNetdiskDownload\graduation_project\project_folder\ansible\plugins\callback\__init__.py,542.0
ansible.plugins.callback.__init__.CallbackBase.v2_playbook_on_stats,580,1,1,0,1,0,0,2.0,2.0,0.0,D:\BaiduNetdiskDownload\graduation_project\project_folder\ansible\plugins\callback\__init__.py,580.0
ansible.plugins.callback.__init__.CallbackBase.v2_playbook_on_task_start,554,1,1,0,1,0,0,2.0,3.0,0.0,D:\BaiduNetdiskDownload\graduation_project\project_folder\ansible\plugins\callback\__init__.py,554.0
ansible.plugins.callback.__init__.CallbackBase.v2_playbook_on_vars_prompt,564,1,1,0,1,0,0,2.0,2.0,0.0,D:\BaiduNetdiskDownload\graduation_project\project_folder\ansible\plugins\callback\__init__.py,564.0
ansible.plugins.callback.__init__.CallbackBase.v2_runner_on_async_failed,533,1,1,0,1,0,0,8.0,2.0,0.0,D:\BaiduNetdiskDownload\graduation_project\project_folder\ansible\plugins\callback\__init__.py,533.0
ansible.plugins.callback.__init__.CallbackBase.v2_runner_on_async_ok,528,1,1,0,1,0,0,4.0,2.0,0.0,D:\BaiduNetdiskDownload\graduation_project\project_folder\ansible\plugins\callback\__init__.py,528.0
ansible.plugins.callback.__init__.CallbackBase.v2_runner_on_async_poll,521,1,1,0,1,0,0,6.0,2.0,0.0,D:\BaiduNetdiskDownload\graduation_project\project_folder\ansible\plugins\callback\__init__.py,521.0
ansible.plugins.callback.__init__.CallbackBase.v2_runner_on_failed,504,1,1,0,1,0,0,3.0,2.0,0.0,D:\BaiduNetdiskDownload\graduation_project\project_folder\ansible\plugins\callback\__init__.py,504.0
ansible.plugins.callback.__init__.CallbackBase.v2_runner_on_ok,508,1,1,0,1,0,0,3.0,2.0,0.0,D:\BaiduNetdiskDownload\graduation_project\project_folder\ansible\plugins\callback\__init__.py,508.0
ansible.plugins.callback.__init__.CallbackBase.v2_runner_on_skipped,512,2,2,0,2,0,0,4.0,2.0,0.0,D:\BaiduNetdiskDownload\graduation_project\project_folder\ansible\plugins\callback\__init__.py,512.0
ansible.plugins.callback.__init__.CallbackBase.v2_runner_on_unreachable,517,1,1,0,1,0,0,3.0,2.0,0.0,D:\BaiduNetdiskDownload\graduation_project\project_folder\ansible\plugins\callback\__init__.py,517.0
ansible.plugins.callback.__init__._AnsibleCallbackDumper.__init__,59,2,0,2,0,0,0,2.0,1.0,0.0,D:\BaiduNetdiskDownload\graduation_project\project_folder\ansible\plugins\callback\__init__.py,59.0
ansible.plugins.callback.__init__._filter_yaml_special,94,2,1,1,1,0,0,3.0,1.0,0.0,D:\BaiduNetdiskDownload\graduation_project\project_folder\ansible\plugins\callback\__init__.py,94.0
ansible.plugins.callback.__init__._munge_data_for_lossy_yaml,99,4,3,1,3,0,0,11.0,1.0,0.0,D:\BaiduNetdiskDownload\graduation_project\project_folder\ansible\plugins\callback\__init__.py,99.0
ansible.plugins.callback.__init__._pretty_represent_str,112,2,2,0,2,0,0,14.0,2.0,0.0,D:\BaiduNetdiskDownload\graduation_project\project_folder\ansible\plugins\callback\__init__.py,112.0
ansible.plugins.callback.__init__._should_use_block,70,1,0,1,0,0,0,7.0,1.0,0.0,D:\BaiduNetdiskDownload\graduation_project\project_folder\ansible\plugins\callback\__init__.py,70.0
ansible.plugins.callback.default.CallbackModule._print_task_banner,164,15,6,9,6,0,0,31.0,2.0,0.0,D:\BaiduNetdiskDownload\graduation_project\project_folder\ansible\plugins\callback\default.py,164.0
ansible.plugins.callback.default.CallbackModule._task_start,144,7,4,3,4,0,0,19.0,2.0,0.0,D:\BaiduNetdiskDownload\graduation_project\project_folder\ansible\plugins\callback\default.py,144.0
ansible.plugins.callback.default.CallbackModule.v2_on_file_diff,221,3,3,0,3,0,0,15.0,2.0,0.0,D:\BaiduNetdiskDownload\graduation_project\project_folder\ansible\plugins\callback\default.py,221.0
ansible.plugins.callback.default.CallbackModule.v2_playbook_on_cleanup_task_start,196,1,1,0,1,0,0,2.0,2.0,0.0,D:\BaiduNetdiskDownload\graduation_project\project_folder\ansible\plugins\callback\default.py,196.0
ansible.plugins.callback.default.CallbackModule.v2_playbook_on_handler_task_start,199,1,1,0,1,0,0,2.0,2.0,0.0,D:\BaiduNetdiskDownload\graduation_project\project_folder\ansible\plugins\callback\default.py,199.0
ansible.plugins.callback.default.CallbackModule.v2_playbook_on_include,291,3,3,0,3,0,0,6.0,2.0,0.0,D:\BaiduNetdiskDownload\graduation_project\project_folder\ansible\plugins\callback\default.py,291.0
ansible.plugins.callback.default.CallbackModule.v2_playbook_on_no_hosts_matched,135,1,1,0,1,0,0,2.0,1.0,0.0,D:\BaiduNetdiskDownload\graduation_project\project_folder\ansible\plugins\callback\default.py,135.0
ansible.plugins.callback.default.CallbackModule.v2_playbook_on_no_hosts_remaining,138,1,1,0,1,0,0,2.0,1.0,0.0,D:\BaiduNetdiskDownload\graduation_project\project_folder\ansible\plugins\callback\default.py,138.0
ansible.plugins.callback.default.CallbackModule.v2_playbook_on_notify,406,1,1,0,1,0,0,3.0,3.0,0.0,D:\BaiduNetdiskDownload\graduation_project\project_folder\ansible\plugins\callback\default.py,406.0
ansible.plugins.callback.default.CallbackModule.v2_playbook_on_play_start,206,3,3,0,3,0,0,14.0,2.0,0.0,D:\BaiduNetdiskDownload\graduation_project\project_folder\ansible\plugins\callback\default.py,206.0
ansible.plugins.callback.default.CallbackModule.v2_playbook_on_start,354,4,4,0,4,0,0,18.0,2.0,0.0,D:\BaiduNetdiskDownload\graduation_project\project_folder\ansible\plugins\callback\default.py,354.0
ansible.plugins.callback.default.CallbackModule.v2_playbook_on_stats,298,8,8,0,8,0,0,55.0,2.0,0.0,D:\BaiduNetdiskDownload\graduation_project\project_folder\ansible\plugins\callback\default.py,298.0
ansible.plugins.callback.default.CallbackModule.v2_playbook_on_task_start,141,1,1,0,1,0,0,2.0,3.0,0.0,D:\BaiduNetdiskDownload\graduation_project\project_folder\ansible\plugins\callback\default.py,141.0
ansible.plugins.callback.default.CallbackModule.v2_runner_item_on_failed,264,9,9,0,9,0,0,15.0,2.0,0.0,D:\BaiduNetdiskDownload\graduation_project\project_folder\ansible\plugins\callback\default.py,264.0
ansible.plugins.callback.default.CallbackModule.v2_runner_item_on_ok,237,8,8,0,8,0,0,26.0,2.0,0.0,D:\BaiduNetdiskDownload\graduation_project\project_folder\ansible\plugins\callback\default.py,237.0
ansible.plugins.callback.default.CallbackModule.v2_runner_item_on_skipped,280,7,7,0,7,0,0,10.0,2.0,0.0,D:\BaiduNetdiskDownload\graduation_project\project_folder\ansible\plugins\callback\default.py,280.0
ansible.plugins.callback.default.CallbackModule.v2_runner_on_async_failed,396,1,1,0,1,0,0,9.0,2.0,0.0,D:\BaiduNetdiskDownload\graduation_project\project_folder\ansible\plugins\callback\default.py,396.0
ansible.plugins.callback.default.CallbackModule.v2_runner_on_async_ok,391,1,1,0,1,0,0,4.0,2.0,0.0,D:\BaiduNetdiskDownload\graduation_project\project_folder\ansible\plugins\callback\default.py,391.0
ansible.plugins.callback.default.CallbackModule.v2_runner_on_async_poll,381,1,1,0,1,0,0,9.0,2.0,0.0,D:\BaiduNetdiskDownload\graduation_project\project_folder\ansible\plugins\callback\default.py,381.0
ansible.plugins.callback.default.CallbackModule.v2_runner_on_failed,49,10,10,0,10,0,0,22.0,2.0,0.0,D:\BaiduNetdiskDownload\graduation_project\project_folder\ansible\plugins\callback\default.py,49.0
ansible.plugins.callback.default.CallbackModule.v2_runner_on_ok,72,9,9,0,9,0,0,34.0,2.0,0.0,D:\BaiduNetdiskDownload\graduation_project\project_folder\ansible\plugins\callback\default.py,72.0
ansible.plugins.callback.default.CallbackModule.v2_runner_on_skipped,107,7,7,0,7,0,0,16.0,2.0,0.0,D:\BaiduNetdiskDownload\graduation_project\project_folder\ansible\plugins\callback\default.py,107.0
ansible.plugins.callback.default.CallbackModule.v2_runner_on_start,202,2,2,0,2,0,0,3.0,3.0,0.0,D:\BaiduNetdiskDownload\graduation_project\project_folder\ansible\plugins\callback\default.py,202.0
ansible.plugins.callback.default.CallbackModule.v2_runner_on_unreachable,124,5,5,0,5,0,0,10.0,2.0,0.0,D:\BaiduNetdiskDownload\graduation_project\project_folder\ansible\plugins\callback\default.py,124.0
ansible.plugins.callback.default.CallbackModule.v2_runner_retry,373,4,4,0,4,0,0,7.0,2.0,0.0,D:\BaiduNetdiskDownload\graduation_project\project_folder\ansible\plugins\callback\default.py,373.0
ansible.plugins.callback.junit.CallbackModule.__init__,139,2,2,0,2,0,0,26.0,1.0,0.0,D:\BaiduNetdiskDownload\graduation_project\project_folder\ansible\plugins\callback\junit.py,139.0
ansible.plugins.callback.junit.CallbackModule._build_test_case,215,9,8,1,8,0,0,48.0,3.0,0.0,D:\BaiduNetdiskDownload\graduation_project\project_folder\ansible\plugins\callback\junit.py,215.0
ansible.plugins.callback.junit.CallbackModule._cleanse_string,264,3,2,1,2,0,0,3.0,2.0,0.0,D:\BaiduNetdiskDownload\graduation_project\project_folder\ansible\plugins\callback\junit.py,264.0
ansible.plugins.callback.junit.CallbackModule._finish_task,186,6,2,4,2,0,0,28.0,3.0,0.0,D:\BaiduNetdiskDownload\graduation_project\project_folder\ansible\plugins\callback\junit.py,186.0
ansible.plugins.callback.junit.CallbackModule._generate_report,268,7,6,1,6,0,0,20.0,1.0,0.0,D:\BaiduNetdiskDownload\graduation_project\project_folder\ansible\plugins\callback\junit.py,268.0
ansible.plugins.callback.junit.CallbackModule._start_task,166,9,5,4,5,0,0,19.0,2.0,0.0,D:\BaiduNetdiskDownload\graduation_project\project_folder\ansible\plugins\callback\junit.py,166.0
ansible.plugins.callback.junit.CallbackModule.v2_playbook_on_cleanup_task_start,302,1,1,0,1,0,0,2.0,2.0,0.0,D:\BaiduNetdiskDownload\graduation_project\project_folder\ansible\plugins\callback\junit.py,302.0
ansible.plugins.callback.junit.CallbackModule.v2_playbook_on_handler_task_start,305,1,1,0,1,0,0,2.0,2.0,0.0,D:\BaiduNetdiskDownload\graduation_project\project_folder\ansible\plugins\callback\junit.py,305.0
ansible.plugins.callback.junit.CallbackModule.v2_playbook_on_include,320,1,1,0,1,0,0,2.0,2.0,0.0,D:\BaiduNetdiskDownload\graduation_project\project_folder\ansible\plugins\callback\junit.py,320.0
ansible.plugins.callback.junit.CallbackModule.v2_playbook_on_stats,323,1,1,0,1,0,0,2.0,2.0,0.0,D:\BaiduNetdiskDownload\graduation_project\project_folder\ansible\plugins\callback\junit.py,323.0
ansible.plugins.callback.junit.CallbackModule.v2_playbook_on_task_start,299,1,1,0,1,0,0,2.0,3.0,0.0,D:\BaiduNetdiskDownload\graduation_project\project_folder\ansible\plugins\callback\junit.py,299.0
ansible.plugins.callback.junit.CallbackModule.v2_runner_on_failed,308,1,1,0,1,0,0,5.0,2.0,0.0,D:\BaiduNetdiskDownload\graduation_project\project_folder\ansible\plugins\callback\junit.py,308.0
ansible.plugins.callback.junit.CallbackModule.v2_runner_on_no_hosts,296,1,1,0,1,0,0,2.0,2.0,0.0,D:\BaiduNetdiskDownload\graduation_project\project_folder\ansible\plugins\callback\junit.py,296.0
ansible.plugins.callback.junit.CallbackModule.v2_runner_on_ok,314,1,1,0,1,0,0,2.0,2.0,0.0,D:\BaiduNetdiskDownload\graduation_project\project_folder\ansible\plugins\callback\junit.py,314.0
ansible.plugins.callback.junit.CallbackModule.v2_runner_on_skipped,317,1,1,0,1,0,0,2.0,2.0,0.0,D:\BaiduNetdiskDownload\graduation_project\project_folder\ansible\plugins\callback\junit.py,317.0
ansible.plugins.callback.junit.HostData.__init__,358,1,0,1,0,0,0,6.0,5.0,0.0,D:\BaiduNetdiskDownload\graduation_project\project_folder\ansible\plugins\callback\junit.py,358.0
ansible.plugins.callback.junit.TaskData.__init__,332,1,0,1,0,0,0,9.0,6.0,0.0,D:\BaiduNetdiskDownload\graduation_project\project_folder\ansible\plugins\callback\junit.py,332.0
ansible.plugins.callback.minimal.CallbackModule._command_generic_msg,33,2,0,2,0,0,0,9.0,4.0,0.0,D:\BaiduNetdiskDownload\graduation_project\project_folder\ansible\plugins\callback\minimal.py,33.0
ansible.plugins.callback.minimal.CallbackModule.v2_on_file_diff,76,2,2,0,2,0,0,3.0,2.0,0.0,D:\BaiduNetdiskDownload\graduation_project\project_folder\ansible\plugins\callback\minimal.py,76.0
ansible.plugins.callback.minimal.CallbackModule.v2_runner_on_failed,43,5,5,0,5,0,0,9.0,2.0,0.0,D:\BaiduNetdiskDownload\graduation_project\project_folder\ansible\plugins\callback\minimal.py,43.0
ansible.plugins.callback.minimal.CallbackModule.v2_runner_on_ok,53,5,5,0,5,0,0,16.0,2.0,0.0,D:\BaiduNetdiskDownload\graduation_project\project_folder\ansible\plugins\callback\minimal.py,53.0
ansible.plugins.callback.minimal.CallbackModule.v2_runner_on_skipped,70,1,1,0,1,0,0,2.0,2.0,0.0,D:\BaiduNetdiskDownload\graduation_project\project_folder\ansible\plugins\callback\minimal.py,70.0
ansible.plugins.callback.minimal.CallbackModule.v2_runner_on_unreachable,73,2,2,0,2,0,0,2.0,2.0,0.0,D:\BaiduNetdiskDownload\graduation_project\project_folder\ansible\plugins\callback\minimal.py,73.0
ansible.plugins.callback.oneline.CallbackModule._command_generic_msg,31,3,1,2,1,0,0,7.0,4.0,0.0,D:\BaiduNetdiskDownload\graduation_project\project_folder\ansible\plugins\callback\oneline.py,31.0
ansible.plugins.callback.oneline.CallbackModule.v2_runner_on_failed,39,6,6,0,6,0,0,16.0,2.0,0.0,D:\BaiduNetdiskDownload\graduation_project\project_folder\ansible\plugins\callback\oneline.py,39.0
ansible.plugins.callback.oneline.CallbackModule.v2_runner_on_ok,56,4,4,0,4,0,0,14.0,2.0,0.0,D:\BaiduNetdiskDownload\graduation_project\project_folder\ansible\plugins\callback\oneline.py,56.0
ansible.plugins.callback.oneline.CallbackModule.v2_runner_on_skipped,74,1,1,0,1,0,0,2.0,2.0,0.0,D:\BaiduNetdiskDownload\graduation_project\project_folder\ansible\plugins\callback\oneline.py,74.0
ansible.plugins.callback.oneline.CallbackModule.v2_runner_on_unreachable,71,1,1,0,1,0,0,2.0,2.0,0.0,D:\BaiduNetdiskDownload\graduation_project\project_folder\ansible\plugins\callback\oneline.py,71.0
ansible.plugins.callback.tree.CallbackModule.result_to_tree,75,5,2,3,2,0,0,2.0,2.0,0.0,D:\BaiduNetdiskDownload\graduation_project\project_folder\ansible\plugins\callback\tree.py,75.0
ansible.plugins.callback.tree.CallbackModule.set_options,48,2,2,0,2,0,0,10.0,1.0,0.0,D:\BaiduNetdiskDownload\graduation_project\project_folder\ansible\plugins\callback\tree.py,48.0
ansible.plugins.callback.tree.CallbackModule.v2_runner_on_failed,81,1,1,0,1,0,0,2.0,2.0,0.0,D:\BaiduNetdiskDownload\graduation_project\project_folder\ansible\plugins\callback\tree.py,81.0
ansible.plugins.callback.tree.CallbackModule.v2_runner_on_ok,78,1,1,0,1,0,0,2.0,2.0,0.0,D:\BaiduNetdiskDownload\graduation_project\project_folder\ansible\plugins\callback\tree.py,78.0
ansible.plugins.callback.tree.CallbackModule.v2_runner_on_unreachable,84,1,1,0,1,0,0,2.0,2.0,0.0,D:\BaiduNetdiskDownload\graduation_project\project_folder\ansible\plugins\callback\tree.py,84.0
ansible.plugins.callback.tree.CallbackModule.write_tree_file,59,6,5,1,5,0,0,15.0,3.0,0.0,D:\BaiduNetdiskDownload\graduation_project\project_folder\ansible\plugins\callback\tree.py,59.0
ansible.plugins.cliconf.__init__.CliconfBase._alarm_handler,85,1,1,0,1,0,0,4.0,3.0,0.0,D:\BaiduNetdiskDownload\graduation_project\project_folder\ansible\plugins\cliconf\__init__.py,85.0
ansible.plugins.cliconf.__init__.CliconfBase._update_cli_prompt_context,456,5,5,0,5,0,0,20.0,1.0,0.0,D:\BaiduNetdiskDownload\graduation_project\project_folder\ansible\plugins\cliconf\__init__.py,456.0
ansible.plugins.cliconf.__init__.CliconfBase.commit,298,1,1,0,1,0,0,12.0,1.0,0.0,D:\BaiduNetdiskDownload\graduation_project\project_folder\ansible\plugins\cliconf\__init__.py,298.0
ansible.plugins.cliconf.__init__.CliconfBase.copy_file,331,3,3,0,3,0,0,20.0,1.0,0.0,D:\BaiduNetdiskDownload\graduation_project\project_folder\ansible\plugins\cliconf\__init__.py,331.0
ansible.plugins.cliconf.__init__.CliconfBase.discard_changes,311,1,1,0,1,0,0,10.0,1.0,0.0,D:\BaiduNetdiskDownload\graduation_project\project_folder\ansible\plugins\cliconf\__init__.py,311.0
ansible.plugins.cliconf.__init__.CliconfBase.get_base_rpc,135,1,0,1,0,0,0,3.0,1.0,0.0,D:\BaiduNetdiskDownload\graduation_project\project_folder\ansible\plugins\cliconf\__init__.py,135.0
ansible.plugins.cliconf.__init__.CliconfBase.get_capabilities,240,2,2,0,2,0,0,45.0,1.0,0.0,D:\BaiduNetdiskDownload\graduation_project\project_folder\ansible\plugins\cliconf\__init__.py,240.0
ansible.plugins.cliconf.__init__.CliconfBase.get_device_info,287,1,0,1,0,0,0,10.0,1.0,0.0,D:\BaiduNetdiskDownload\graduation_project\project_folder\ansible\plugins\cliconf\__init__.py,287.0
ansible.plugins.cliconf.__init__.CliconfBase.get_file,352,2,2,0,2,0,0,23.0,1.0,0.0,D:\BaiduNetdiskDownload\graduation_project\project_folder\ansible\plugins\cliconf\__init__.py,352.0
ansible.plugins.cliconf.__init__.CliconfBase.send_command,90,4,3,1,3,0,0,44.0,1.0,0.0,D:\BaiduNetdiskDownload\graduation_project\project_folder\ansible\plugins\cliconf\__init__.py,90.0
ansible.plugins.cliconf.__init__.enable_mode,35,5,5,0,5,0,0,8.0,1.0,2.0,D:\BaiduNetdiskDownload\graduation_project\project_folder\ansible\plugins\cliconf\__init__.py,35.0
ansible.plugins.connection.__init__.ConnectionBase.__init__,71,1,1,0,1,0,0,36.0,4.0,0.0,D:\BaiduNetdiskDownload\graduation_project\project_folder\ansible\plugins\connection\__init__.py,71.0
ansible.plugins.connection.__init__.ConnectionBase._new_stdin,109,1,1,0,1,0,0,7.0,1.0,0.0,D:\BaiduNetdiskDownload\graduation_project\project_folder\ansible\plugins\connection\__init__.py,109.0
ansible.plugins.connection.__init__.ConnectionBase._split_ssh_args,131,4,3,1,3,0,0,8.0,1.0,0.0,D:\BaiduNetdiskDownload\graduation_project\project_folder\ansible\plugins\connection\__init__.py,131.0
ansible.plugins.connection.__init__.ConnectionBase.connection_lock,235,1,1,0,1,0,0,5.0,1.0,0.0,D:\BaiduNetdiskDownload\graduation_project\project_folder\ansible\plugins\connection\__init__.py,235.0
ansible.plugins.connection.__init__.ConnectionBase.connection_unlock,241,1,1,0,1,0,0,4.0,1.0,0.0,D:\BaiduNetdiskDownload\graduation_project\project_folder\ansible\plugins\connection\__init__.py,241.0
ansible.plugins.connection.__init__.ConnectionBase.reset,246,1,1,0,1,0,0,2.0,1.0,0.0,D:\BaiduNetdiskDownload\graduation_project\project_folder\ansible\plugins\connection\__init__.py,246.0
ansible.plugins.connection.__init__.ConnectionBase.update_vars,249,3,3,0,3,0,0,38.0,3.0,0.0,D:\BaiduNetdiskDownload\graduation_project\project_folder\ansible\plugins\connection\__init__.py,249.0
ansible.plugins.connection.__init__.NetworkConnectionBase.__getattr__,321,1,1,0,1,0,0,11.0,2.0,0.0,D:\BaiduNetdiskDownload\graduation_project\project_folder\ansible\plugins\connection\__init__.py,321.0
ansible.plugins.connection.__init__.NetworkConnectionBase.__init__,298,2,2,0,2,0,0,22.0,4.0,0.0,D:\BaiduNetdiskDownload\graduation_project\project_folder\ansible\plugins\connection\__init__.py,298.0
ansible.plugins.connection.__init__.NetworkConnectionBase._log_messages,415,1,1,0,1,0,0,3.0,2.0,0.0,D:\BaiduNetdiskDownload\graduation_project\project_folder\ansible\plugins\connection\__init__.py,415.0
ansible.plugins.connection.__init__.NetworkConnectionBase._update_connection_state,392,3,2,1,2,0,0,22.0,1.0,0.0,D:\BaiduNetdiskDownload\graduation_project\project_folder\ansible\plugins\connection\__init__.py,392.0
ansible.plugins.connection.__init__.NetworkConnectionBase.close,367,1,0,1,0,0,0,4.0,1.0,0.0,D:\BaiduNetdiskDownload\graduation_project\project_folder\ansible\plugins\connection\__init__.py,367.0
ansible.plugins.connection.__init__.NetworkConnectionBase.exec_command,333,2,1,1,1,1,1,2.0,2.0,0.0,D:\BaiduNetdiskDownload\graduation_project\project_folder\ansible\plugins\connection\__init__.py,333.0
ansible.plugins.connection.__init__.NetworkConnectionBase.fetch_file,354,2,1,1,1,1,1,3.0,3.0,0.0,D:\BaiduNetdiskDownload\graduation_project\project_folder\ansible\plugins\connection\__init__.py,354.0
ansible.plugins.connection.__init__.NetworkConnectionBase.pop_messages,346,3,0,3,0,0,0,3.0,1.0,0.0,D:\BaiduNetdiskDownload\graduation_project\project_folder\ansible\plugins\connection\__init__.py,346.0
ansible.plugins.connection.__init__.NetworkConnectionBase.put_file,350,2,1,1,1,1,1,3.0,3.0,0.0,D:\BaiduNetdiskDownload\graduation_project\project_folder\ansible\plugins\connection\__init__.py,350.0
ansible.plugins.connection.__init__.NetworkConnectionBase.queue_message,336,6,1,5,1,0,0,9.0,3.0,0.0,D:\BaiduNetdiskDownload\graduation_project\project_folder\ansible\plugins\connection\__init__.py,336.0
ansible.plugins.connection.__init__.NetworkConnectionBase.reset,358,2,2,0,2,0,0,8.0,1.0,0.0,D:\BaiduNetdiskDownload\graduation_project\project_folder\ansible\plugins\connection\__init__.py,358.0
ansible.plugins.connection.__init__.NetworkConnectionBase.set_options,372,4,2,2,2,1,1,19.0,4.0,0.0,D:\BaiduNetdiskDownload\graduation_project\project_folder\ansible\plugins\connection\__init__.py,372.0
ansible.plugins.connection.__init__.ensure_connect,38,1,1,0,1,0,0,9.0,3.0,2.0,D:\BaiduNetdiskDownload\graduation_project\project_folder\ansible\plugins\connection\__init__.py,38.0
ansible.plugins.connection.local.Connection.__init__,46,1,1,0,1,0,0,9.0,3.0,0.0,D:\BaiduNetdiskDownload\graduation_project\project_folder\ansible\plugins\connection\local.py,46.0
ansible.plugins.connection.local.Connection._connect,56,2,2,0,2,0,0,11.0,1.0,0.0,D:\BaiduNetdiskDownload\graduation_project\project_folder\ansible\plugins\connection\local.py,56.0
ansible.plugins.connection.local.Connection.exec_command,68,11,11,0,11,0,0,97.0,2.0,0.0,D:\BaiduNetdiskDownload\graduation_project\project_folder\ansible\plugins\connection\local.py,68.0
ansible.plugins.connection.local.Connection.fetch_file,184,3,3,0,3,0,0,7.0,3.0,0.0,D:\BaiduNetdiskDownload\graduation_project\project_folder\ansible\plugins\connection\local.py,184.0
ansible.plugins.connection.local.Connection.put_file,166,7,6,1,6,0,0,17.0,3.0,0.0,D:\BaiduNetdiskDownload\graduation_project\project_folder\ansible\plugins\connection\local.py,166.0
ansible.plugins.connection.paramiko_ssh.Connection._any_keys_added,589,3,1,2,1,0,0,8.0,1.0,0.0,D:\BaiduNetdiskDownload\graduation_project\project_folder\ansible\plugins\connection\paramiko_ssh.py,589.0
ansible.plugins.connection.paramiko_ssh.Connection._cache_key,329,2,0,2,0,0,0,2.0,1.0,0.0,D:\BaiduNetdiskDownload\graduation_project\project_folder\ansible\plugins\connection\paramiko_ssh.py,329.0
ansible.plugins.connection.paramiko_ssh.Connection._connect,332,4,2,2,2,0,0,9.0,1.0,0.0,D:\BaiduNetdiskDownload\graduation_project\project_folder\ansible\plugins\connection\paramiko_ssh.py,332.0
ansible.plugins.connection.paramiko_ssh.Connection._connect_sftp,563,2,1,1,1,0,0,8.0,1.0,0.0,D:\BaiduNetdiskDownload\graduation_project\project_folder\ansible\plugins\connection\paramiko_ssh.py,563.0
ansible.plugins.connection.paramiko_ssh.Connection._connect_uncached,368,11,8,3,8,0,0,94.0,1.0,0.0,D:\BaiduNetdiskDownload\graduation_project\project_folder\ansible\plugins\connection\paramiko_ssh.py,368.0
ansible.plugins.connection.paramiko_ssh.Connection._parse_proxy_command,346,5,4,1,4,0,0,21.0,1.0,0.0,D:\BaiduNetdiskDownload\graduation_project\project_folder\ansible\plugins\connection\paramiko_ssh.py,346.0
ansible.plugins.connection.paramiko_ssh.Connection._save_ssh_host_keys,598,5,4,1,4,0,0,29.0,2.0,0.0,D:\BaiduNetdiskDownload\graduation_project\project_folder\ansible\plugins\connection\paramiko_ssh.py,598.0
ansible.plugins.connection.paramiko_ssh.Connection.close,634,9,7,2,7,1,1,66.0,1.0,0.0,D:\BaiduNetdiskDownload\graduation_project\project_folder\ansible\plugins\connection\paramiko_ssh.py,634.0
ansible.plugins.connection.paramiko_ssh.Connection.exec_command,463,9,9,0,9,0,0,79.0,2.0,0.0,D:\BaiduNetdiskDownload\graduation_project\project_folder\ansible\plugins\connection\paramiko_ssh.py,463.0
ansible.plugins.connection.paramiko_ssh.Connection.fetch_file,572,4,4,0,4,0,0,16.0,3.0,0.0,D:\BaiduNetdiskDownload\graduation_project\project_folder\ansible\plugins\connection\paramiko_ssh.py,572.0
ansible.plugins.connection.paramiko_ssh.Connection.put_file,543,5,5,0,5,0,0,19.0,3.0,0.0,D:\BaiduNetdiskDownload\graduation_project\project_folder\ansible\plugins\connection\paramiko_ssh.py,543.0
ansible.plugins.connection.paramiko_ssh.Connection.reset,628,2,2,0,2,0,0,5.0,1.0,0.0,D:\BaiduNetdiskDownload\graduation_project\project_folder\ansible\plugins\connection\paramiko_ssh.py,628.0
ansible.plugins.connection.paramiko_ssh.MyAddPolicy.__init__,284,1,0,1,0,0,0,3.0,2.0,0.0,D:\BaiduNetdiskDownload\graduation_project\project_folder\ansible\plugins\connection\paramiko_ssh.py,284.0
ansible.plugins.connection.paramiko_ssh.MyAddPolicy.missing_host_key,288,4,4,0,4,0,0,24.0,4.0,0.0,D:\BaiduNetdiskDownload\graduation_project\project_folder\ansible\plugins\connection\paramiko_ssh.py,288.0
ansible.plugins.connection.psrp.Connection._build_kwargs,707,5,4,1,4,0,0,103.0,1.0,0.0,D:\BaiduNetdiskDownload\graduation_project\project_folder\ansible\plugins\connection\psrp.py,707.0
ansible.plugins.connection.psrp.Connection._connect,368,6,5,1,5,0,0,46.0,1.0,0.0,D:\BaiduNetdiskDownload\graduation_project\project_folder\ansible\plugins\connection\psrp.py,368.0
ansible.plugins.connection.psrp.Connection._exec_psrp_script,811,5,2,3,2,0,0,31.0,2.0,0.0,D:\BaiduNetdiskDownload\graduation_project\project_folder\ansible\plugins\connection\psrp.py,811.0
ansible.plugins.connection.psrp.Connection._parse_pipeline_result,843,7,6,1,6,0,0,68.0,2.0,0.0,D:\BaiduNetdiskDownload\graduation_project\project_folder\ansible\plugins\connection\psrp.py,843.0
ansible.plugins.connection.psrp.Connection.close,698,4,2,2,2,1,1,8.0,1.0,0.0,D:\BaiduNetdiskDownload\graduation_project\project_folder\ansible\plugins\connection\psrp.py,698.0
ansible.plugins.connection.psrp.Connection.exec_command,431,8,8,0,8,0,0,40.0,2.0,0.0,D:\BaiduNetdiskDownload\graduation_project\project_folder\ansible\plugins\connection\psrp.py,431.0
ansible.plugins.connection.psrp.Connection.fetch_file,620,11,11,0,11,0,0,77.0,3.0,0.0,D:\BaiduNetdiskDownload\graduation_project\project_folder\ansible\plugins\connection\psrp.py,620.0
ansible.plugins.connection.psrp.Connection.put_file,472,9,9,0,9,0,0,147.0,3.0,2.0,D:\BaiduNetdiskDownload\graduation_project\project_folder\ansible\plugins\connection\psrp.py,472.0
ansible.plugins.connection.psrp.Connection.reset,415,5,5,0,5,0,0,15.0,1.0,0.0,D:\BaiduNetdiskDownload\graduation_project\project_folder\ansible\plugins\connection\psrp.py,415.0
ansible.plugins.connection.ssh.Connection._add_args,651,4,3,1,3,0,0,15.0,4.0,0.0,D:\BaiduNetdiskDownload\graduation_project\project_folder\ansible\plugins\connection\ssh.py,651.0
ansible.plugins.connection.ssh.Connection._bare_run,909,16,14,2,14,0,0,294.0,3.0,0.0,D:\BaiduNetdiskDownload\graduation_project\project_folder\ansible\plugins\connection\ssh.py,909.0
ansible.plugins.connection.ssh.Connection._build_command,667,14,11,3,11,0,0,156.0,4.0,0.0,D:\BaiduNetdiskDownload\graduation_project\project_folder\ansible\plugins\connection\ssh.py,667.0
ansible.plugins.connection.ssh.Connection._create_control_path,594,5,2,3,2,0,0,18.0,3.0,0.0,D:\BaiduNetdiskDownload\graduation_project\project_folder\ansible\plugins\connection\ssh.py,594.0
ansible.plugins.connection.ssh.Connection._escape_win_path,1281,3,1,2,1,0,0,9.0,2.0,0.0,D:\BaiduNetdiskDownload\graduation_project\project_folder\ansible\plugins\connection\ssh.py,1281.0
ansible.plugins.connection.ssh.Connection._examine_output,860,13,12,1,12,0,0,48.0,5.0,0.0,D:\BaiduNetdiskDownload\graduation_project\project_folder\ansible\plugins\connection\ssh.py,860.0
ansible.plugins.connection.ssh.Connection._file_transport_command,1211,13,11,2,11,0,0,69.0,4.0,0.0,D:\BaiduNetdiskDownload\graduation_project\project_folder\ansible\plugins\connection\ssh.py,1211.0
ansible.plugins.connection.ssh.Connection._persistence_controls,632,2,1,1,1,0,0,18.0,1.0,0.0,D:\BaiduNetdiskDownload\graduation_project\project_folder\ansible\plugins\connection\ssh.py,632.0
ansible.plugins.connection.ssh.Connection._run,1205,2,1,1,1,0,0,4.0,3.0,0.0,D:\BaiduNetdiskDownload\graduation_project\project_folder\ansible\plugins\connection\ssh.py,1205.0
ansible.plugins.connection.ssh.Connection._send_initial_data,824,4,3,1,3,0,0,24.0,4.0,0.0,D:\BaiduNetdiskDownload\graduation_project\project_folder\ansible\plugins\connection\ssh.py,824.0
ansible.plugins.connection.ssh.Connection._sshpass_available,614,1,0,1,0,0,0,16.0,1.0,0.0,D:\BaiduNetdiskDownload\graduation_project\project_folder\ansible\plugins\connection\ssh.py,614.0
ansible.plugins.connection.ssh.Connection._terminate_process,851,2,1,1,1,0,0,6.0,1.0,0.0,D:\BaiduNetdiskDownload\graduation_project\project_folder\ansible\plugins\connection\ssh.py,851.0
ansible.plugins.connection.ssh.Connection.close,1403,1,0,1,0,0,0,2.0,1.0,0.0,D:\BaiduNetdiskDownload\graduation_project\project_folder\ansible\plugins\connection\ssh.py,1403.0
ansible.plugins.connection.ssh.Connection.exec_command,1294,10,9,1,9,0,0,48.0,2.0,0.0,D:\BaiduNetdiskDownload\graduation_project\project_folder\ansible\plugins\connection\ssh.py,1294.0
ansible.plugins.connection.ssh.Connection.fetch_file,1359,4,4,0,4,0,0,14.0,3.0,0.0,D:\BaiduNetdiskDownload\graduation_project\project_folder\ansible\plugins\connection\ssh.py,1359.0
ansible.plugins.connection.ssh.Connection.put_file,1343,6,6,0,6,0,0,15.0,3.0,0.0,D:\BaiduNetdiskDownload\graduation_project\project_folder\ansible\plugins\connection\ssh.py,1343.0
ansible.plugins.connection.ssh.Connection.reset,1374,5,5,0,5,0,0,28.0,1.0,0.0,D:\BaiduNetdiskDownload\graduation_project\project_folder\ansible\plugins\connection\ssh.py,1374.0
ansible.plugins.connection.ssh._handle_error,417,6,5,1,5,0,0,61.0,7.0,0.0,D:\BaiduNetdiskDownload\graduation_project\project_folder\ansible\plugins\connection\ssh.py,417.0
ansible.plugins.connection.ssh._ssh_retry,480,6,6,0,6,0,0,79.0,5.0,2.0,D:\BaiduNetdiskDownload\graduation_project\project_folder\ansible\plugins\connection\ssh.py,480.0
ansible.plugins.connection.winrm.Connection._build_winrm_kwargs,268,5,4,1,4,0,0,71.0,1.0,0.0,D:\BaiduNetdiskDownload\graduation_project\project_folder\ansible\plugins\connection\winrm.py,268.0
ansible.plugins.connection.winrm.Connection._connect,700,4,3,1,3,0,0,13.0,1.0,0.0,D:\BaiduNetdiskDownload\graduation_project\project_folder\ansible\plugins\connection\winrm.py,700.0
ansible.plugins.connection.winrm.Connection._kerb_auth,342,13,12,1,12,0,0,95.0,3.0,0.0,D:\BaiduNetdiskDownload\graduation_project\project_folder\ansible\plugins\connection\winrm.py,342.0
ansible.plugins.connection.winrm.Connection._put_file_stdin_iterator,742,4,3,1,3,0,0,14.0,3.0,0.0,D:\BaiduNetdiskDownload\graduation_project\project_folder\ansible\plugins\connection\winrm.py,742.0
ansible.plugins.connection.winrm.Connection._winrm_connect,438,12,10,2,10,0,0,58.0,1.0,0.0,D:\BaiduNetdiskDownload\graduation_project\project_folder\ansible\plugins\connection\winrm.py,438.0
ansible.plugins.connection.winrm.Connection._winrm_exec,619,17,14,3,14,0,0,80.0,3.0,0.0,D:\BaiduNetdiskDownload\graduation_project\project_folder\ansible\plugins\connection\winrm.py,619.0
ansible.plugins.connection.winrm.Connection._winrm_get_command_output,590,4,3,1,3,0,0,28.0,4.0,0.0,D:\BaiduNetdiskDownload\graduation_project\project_folder\ansible\plugins\connection\winrm.py,590.0
ansible.plugins.connection.winrm.Connection._winrm_get_raw_command_output,548,4,3,1,3,0,0,41.0,4.0,0.0,D:\BaiduNetdiskDownload\graduation_project\project_folder\ansible\plugins\connection\winrm.py,548.0
ansible.plugins.connection.winrm.Connection._winrm_send_input,534,2,1,1,1,0,0,13.0,5.0,0.0,D:\BaiduNetdiskDownload\graduation_project\project_folder\ansible\plugins\connection\winrm.py,534.0
ansible.plugins.connection.winrm.Connection._winrm_write_stdin,497,3,2,1,2,0,0,36.0,4.0,0.0,D:\BaiduNetdiskDownload\graduation_project\project_folder\ansible\plugins\connection\winrm.py,497.0
ansible.plugins.connection.winrm.Connection._wrapper_payload_stream,721,2,1,1,1,0,0,5.0,2.0,0.0,D:\BaiduNetdiskDownload\graduation_project\project_folder\ansible\plugins\connection\winrm.py,721.0
ansible.plugins.connection.winrm.Connection.close,889,1,1,0,1,0,0,7.0,1.0,0.0,D:\BaiduNetdiskDownload\graduation_project\project_folder\ansible\plugins\connection\winrm.py,889.0
ansible.plugins.connection.winrm.Connection.exec_command,727,5,4,1,4,0,0,13.0,2.0,0.0,D:\BaiduNetdiskDownload\graduation_project\project_folder\ansible\plugins\connection\winrm.py,727.0
ansible.plugins.connection.winrm.Connection.fetch_file,819,12,12,0,12,0,0,69.0,3.0,0.0,D:\BaiduNetdiskDownload\graduation_project\project_folder\ansible\plugins\connection\winrm.py,819.0
ansible.plugins.connection.winrm.Connection.put_file,757,12,12,0,12,0,0,61.0,3.0,0.0,D:\BaiduNetdiskDownload\graduation_project\project_folder\ansible\plugins\connection\winrm.py,757.0
ansible.plugins.connection.winrm.Connection.reset,714,3,1,2,1,0,0,6.0,1.0,0.0,D:\BaiduNetdiskDownload\graduation_project\project_folder\ansible\plugins\connection\winrm.py,714.0
ansible.plugins.filter.core.b64decode,475,2,2,0,2,0,0,2.0,1.0,0.0,D:\BaiduNetdiskDownload\graduation_project\project_folder\ansible\plugins\filter\core.py,475.0
ansible.plugins.filter.core.b64encode,471,2,2,0,2,0,0,2.0,1.0,0.0,D:\BaiduNetdiskDownload\graduation_project\project_folder\ansible\plugins\filter\core.py,471.0
ansible.plugins.filter.core.combine,339,4,4,0,4,0,0,31.0,2.0,0.0,D:\BaiduNetdiskDownload\graduation_project\project_folder\ansible\plugins\filter\core.py,339.0
ansible.plugins.filter.core.comment,372,3,3,0,3,0,0,81.0,2.0,0.0,D:\BaiduNetdiskDownload\graduation_project\project_folder\ansible\plugins\filter\core.py,372.0
ansible.plugins.filter.core.commonpath,587,1,1,0,1,0,0,13.0,1.0,0.0,D:\BaiduNetdiskDownload\graduation_project\project_folder\ansible\plugins\filter\core.py,587.0
ansible.plugins.filter.core.dict_to_list_of_dict_key_value_elements,546,1,1,0,1,0,0,11.0,1.0,0.0,D:\BaiduNetdiskDownload\graduation_project\project_folder\ansible\plugins\filter\core.py,546.0
ansible.plugins.filter.core.extract,456,1,0,1,0,0,0,13.0,3.0,0.0,D:\BaiduNetdiskDownload\graduation_project\project_folder\ansible\plugins\filter\core.py,456.0
ansible.plugins.filter.core.flatten,479,6,4,2,4,1,1,19.0,1.0,0.0,D:\BaiduNetdiskDownload\graduation_project\project_folder\ansible\plugins\filter\core.py,479.0
ansible.plugins.filter.core.from_yaml,217,1,1,0,1,0,0,7.0,1.0,0.0,D:\BaiduNetdiskDownload\graduation_project\project_folder\ansible\plugins\filter\core.py,217.0
ansible.plugins.filter.core.from_yaml_all,226,1,1,0,1,0,0,7.0,1.0,0.0,D:\BaiduNetdiskDownload\graduation_project\project_folder\ansible\plugins\filter\core.py,226.0
ansible.plugins.filter.core.get_encrypted_password,279,5,5,0,5,0,0,30.0,1.0,0.0,D:\BaiduNetdiskDownload\graduation_project\project_folder\ansible\plugins\filter\core.py,279.0
ansible.plugins.filter.core.get_hash,268,1,1,0,1,0,0,9.0,1.0,0.0,D:\BaiduNetdiskDownload\graduation_project\project_folder\ansible\plugins\filter\core.py,268.0
ansible.plugins.filter.core.list_of_dict_key_value_elements_to_dict,559,1,1,0,1,0,0,16.0,1.0,0.0,D:\BaiduNetdiskDownload\graduation_project\project_folder\ansible\plugins\filter\core.py,559.0
ansible.plugins.filter.core.mandatory,322,1,1,0,1,0,0,15.0,1.0,0.0,D:\BaiduNetdiskDownload\graduation_project\project_folder\ansible\plugins\filter\core.py,322.0
ansible.plugins.filter.core.path_join,577,2,2,0,2,0,0,8.0,1.0,0.0,D:\BaiduNetdiskDownload\graduation_project\project_folder\ansible\plugins\filter\core.py,577.0
ansible.plugins.filter.core.quote,112,3,1,2,1,0,0,5.0,1.0,0.0,D:\BaiduNetdiskDownload\graduation_project\project_folder\ansible\plugins\filter\core.py,112.0
ansible.plugins.filter.core.regex_escape,198,2,2,0,2,0,0,17.0,1.0,0.0,D:\BaiduNetdiskDownload\graduation_project\project_folder\ansible\plugins\filter\core.py,198.0
ansible.plugins.filter.core.regex_findall,142,1,1,0,1,0,0,11.0,2.0,0.0,D:\BaiduNetdiskDownload\graduation_project\project_folder\ansible\plugins\filter\core.py,142.0
ansible.plugins.filter.core.regex_replace,124,2,1,1,1,0,0,16.0,0.0,0.0,D:\BaiduNetdiskDownload\graduation_project\project_folder\ansible\plugins\filter\core.py,124.0
ansible.plugins.filter.core.regex_search,155,3,3,0,3,0,0,31.0,4.0,0.0,D:\BaiduNetdiskDownload\graduation_project\project_folder\ansible\plugins\filter\core.py,155.0
ansible.plugins.filter.core.strftime,98,6,0,6,0,0,0,12.0,1.0,0.0,D:\BaiduNetdiskDownload\graduation_project\project_folder\ansible\plugins\filter\core.py,98.0
ansible.plugins.filter.core.subelements,500,3,3,0,3,0,0,44.0,2.0,0.0,D:\BaiduNetdiskDownload\graduation_project\project_folder\ansible\plugins\filter\core.py,500.0
ansible.plugins.filter.core.to_bool,83,1,1,0,1,0,0,9.0,1.0,0.0,D:\BaiduNetdiskDownload\graduation_project\project_folder\ansible\plugins\filter\core.py,83.0
ansible.plugins.filter.core.to_json,64,1,0,1,0,0,0,10.0,3.0,0.0,D:\BaiduNetdiskDownload\graduation_project\project_folder\ansible\plugins\filter\core.py,64.0
ansible.plugins.filter.core.to_nice_json,76,2,2,0,2,0,0,5.0,3.0,0.0,D:\BaiduNetdiskDownload\graduation_project\project_folder\ansible\plugins\filter\core.py,76.0
ansible.plugins.filter.core.to_nice_yaml,55,1,1,0,1,0,0,7.0,3.0,0.0,D:\BaiduNetdiskDownload\graduation_project\project_folder\ansible\plugins\filter\core.py,55.0
ansible.plugins.filter.core.to_uuid,311,1,1,0,1,0,0,9.0,1.0,0.0,D:\BaiduNetdiskDownload\graduation_project\project_folder\ansible\plugins\filter\core.py,311.0
ansible.plugins.filter.core.to_yaml,45,2,2,0,2,0,0,8.0,3.0,0.0,D:\BaiduNetdiskDownload\graduation_project\project_folder\ansible\plugins\filter\core.py,45.0
ansible.plugins.filter.encryption.do_unvault,51,7,7,0,7,0,0,32.0,2.0,0.0,D:\BaiduNetdiskDownload\graduation_project\project_folder\ansible\plugins\filter\encryption.py,51.0
ansible.plugins.filter.encryption.do_vault,18,7,7,0,7,0,0,31.0,2.0,0.0,D:\BaiduNetdiskDownload\graduation_project\project_folder\ansible\plugins\filter\encryption.py,18.0
ansible.plugins.filter.mathstuff.difference,93,1,1,0,1,0,0,6.0,3.0,0.0,D:\BaiduNetdiskDownload\graduation_project\project_folder\ansible\plugins\filter\mathstuff.py,93.0
ansible.plugins.filter.mathstuff.intersect,84,2,1,1,1,0,0,6.0,3.0,0.0,D:\BaiduNetdiskDownload\graduation_project\project_folder\ansible\plugins\filter\mathstuff.py,84.0
ansible.plugins.filter.mathstuff.rekey_on_member,167,2,2,0,2,0,0,48.0,2.0,0.0,D:\BaiduNetdiskDownload\graduation_project\project_folder\ansible\plugins\filter\mathstuff.py,167.0
ansible.plugins.filter.mathstuff.symmetric_difference,102,10,2,8,2,0,0,7.0,3.0,0.0,D:\BaiduNetdiskDownload\graduation_project\project_folder\ansible\plugins\filter\mathstuff.py,102.0
ansible.plugins.filter.mathstuff.union,112,2,1,1,1,0,0,6.0,3.0,0.0,D:\BaiduNetdiskDownload\graduation_project\project_folder\ansible\plugins\filter\mathstuff.py,112.0
ansible.plugins.filter.mathstuff.unique,49,6,3,3,3,0,0,32.0,2.0,2.0,D:\BaiduNetdiskDownload\graduation_project\project_folder\ansible\plugins\filter\mathstuff.py,49.0
ansible.plugins.httpapi.__init__.HttpApiBase.handle_httperror,53,2,2,0,2,0,0,29.0,2.0,0.0,D:\BaiduNetdiskDownload\graduation_project\project_folder\ansible\plugins\httpapi\__init__.py,53.0
ansible.plugins.httpapi.__init__.HttpApiBase.login,23,1,0,1,0,0,0,8.0,3.0,0.0,D:\BaiduNetdiskDownload\graduation_project\project_folder\ansible\plugins\httpapi\__init__.py,23.0
ansible.plugins.inventory.__init__.BaseInventoryPlugin._consume_options,246,1,1,0,1,0,0,9.0,2.0,0.0,D:\BaiduNetdiskDownload\graduation_project\project_folder\ansible\plugins\inventory\__init__.py,246.0
ansible.plugins.inventory.__init__.BaseInventoryPlugin._expand_hostpattern,256,4,3,1,3,0,0,24.0,2.0,0.0,D:\BaiduNetdiskDownload\graduation_project\project_folder\ansible\plugins\inventory\__init__.py,256.0
ansible.plugins.inventory.__init__.BaseInventoryPlugin._populate_host_vars,203,4,0,4,0,0,0,8.0,3.0,0.0,D:\BaiduNetdiskDownload\graduation_project\project_folder\ansible\plugins\inventory\__init__.py,203.0
ansible.plugins.inventory.__init__.BaseInventoryPlugin._read_config_data,212,6,4,2,4,0,0,33.0,2.0,0.0,D:\BaiduNetdiskDownload\graduation_project\project_folder\ansible\plugins\inventory\__init__.py,212.0
ansible.plugins.inventory.__init__.BaseInventoryPlugin.parse,168,2,2,0,2,0,0,18.0,4.0,0.0,D:\BaiduNetdiskDownload\graduation_project\project_folder\ansible\plugins\inventory\__init__.py,168.0
ansible.plugins.inventory.__init__.BaseInventoryPlugin.verify_file,187,2,2,0,2,0,0,15.0,2.0,0.0,D:\BaiduNetdiskDownload\graduation_project\project_folder\ansible\plugins\inventory\__init__.py,187.0
ansible.plugins.inventory.__init__.Cacheable._get_cache_prefix,309,3,2,1,2,0,0,12.0,2.0,0.0,D:\BaiduNetdiskDownload\graduation_project\project_folder\ansible\plugins\inventory\__init__.py,309.0
ansible.plugins.inventory.__init__.Cacheable.get_cache_key,306,2,2,0,2,0,0,2.0,2.0,0.0,D:\BaiduNetdiskDownload\graduation_project\project_folder\ansible\plugins\inventory\__init__.py,306.0
ansible.plugins.inventory.__init__.Cacheable.load_cache_plugin,300,1,1,0,1,0,0,5.0,1.0,0.0,D:\BaiduNetdiskDownload\graduation_project\project_folder\ansible\plugins\inventory\__init__.py,300.0
ansible.plugins.inventory.__init__.Cacheable.set_cache_plugin,328,1,1,0,1,0,0,2.0,1.0,0.0,D:\BaiduNetdiskDownload\graduation_project\project_folder\ansible\plugins\inventory\__init__.py,328.0
ansible.plugins.inventory.__init__.Cacheable.update_cache_if_changed,325,2,1,1,1,1,1,2.0,1.0,0.0,D:\BaiduNetdiskDownload\graduation_project\project_folder\ansible\plugins\inventory\__init__.py,325.0
ansible.plugins.inventory.__init__.Constructable._add_host_to_composed_groups,363,4,3,1,3,0,0,22.0,4.0,0.0,D:\BaiduNetdiskDownload\graduation_project\project_folder\ansible\plugins\inventory\__init__.py,363.0
ansible.plugins.inventory.__init__.Constructable._add_host_to_keyed_groups,386,6,5,1,5,0,0,76.0,4.0,0.0,D:\BaiduNetdiskDownload\graduation_project\project_folder\ansible\plugins\inventory\__init__.py,386.0
ansible.plugins.inventory.__init__.Constructable._compose,334,3,1,2,1,0,0,16.0,3.0,0.0,D:\BaiduNetdiskDownload\graduation_project\project_folder\ansible\plugins\inventory\__init__.py,334.0
ansible.plugins.inventory.__init__.Constructable._set_composite_vars,351,3,2,1,2,0,0,11.0,4.0,0.0,D:\BaiduNetdiskDownload\graduation_project\project_folder\ansible\plugins\inventory\__init__.py,351.0
ansible.plugins.inventory.__init__.detect_range,47,2,0,2,0,0,0,8.0,0.0,0.0,D:\BaiduNetdiskDownload\graduation_project\project_folder\ansible\plugins\inventory\__init__.py,47.0
ansible.plugins.inventory.__init__.expand_hostname_range,57,11,9,2,9,1,1,70.0,0.0,0.0,D:\BaiduNetdiskDownload\graduation_project\project_folder\ansible\plugins\inventory\__init__.py,57.0
ansible.plugins.inventory.__init__.get_cache_plugin,129,4,2,2,2,0,0,17.0,2.0,0.0,D:\BaiduNetdiskDownload\graduation_project\project_folder\ansible\plugins\inventory\__init__.py,129.0
ansible.plugins.inventory.__init__.to_safe_group_name,42,1,1,0,1,0,0,3.0,1.0,0.0,D:\BaiduNetdiskDownload\graduation_project\project_folder\ansible\plugins\inventory\__init__.py,42.0
ansible.plugins.inventory.advanced_host_list.InventoryModule.parse,42,5,5,0,5,0,0,21.0,4.0,0.0,D:\BaiduNetdiskDownload\graduation_project\project_folder\ansible\plugins\inventory\advanced_host_list.py,42.0
ansible.plugins.inventory.advanced_host_list.InventoryModule.verify_file,34,1,1,0,1,0,0,7.0,2.0,0.0,D:\BaiduNetdiskDownload\graduation_project\project_folder\ansible\plugins\inventory\advanced_host_list.py,34.0
ansible.plugins.inventory.auto.InventoryModule.parse,38,3,3,0,3,0,0,25.0,4.0,0.0,D:\BaiduNetdiskDownload\graduation_project\project_folder\ansible\plugins\inventory\auto.py,38.0
ansible.plugins.inventory.auto.InventoryModule.verify_file,33,1,1,0,1,0,0,4.0,2.0,0.0,D:\BaiduNetdiskDownload\graduation_project\project_folder\ansible\plugins\inventory\auto.py,33.0
ansible.plugins.inventory.constructed.InventoryModule.__init__,99,1,1,0,1,0,0,5.0,1.0,0.0,D:\BaiduNetdiskDownload\graduation_project\project_folder\ansible\plugins\inventory\constructed.py,99.0
ansible.plugins.inventory.constructed.InventoryModule.get_all_host_vars,116,4,3,1,3,0,0,3.0,4.0,0.0,D:\BaiduNetdiskDownload\graduation_project\project_folder\ansible\plugins\inventory\constructed.py,116.0
ansible.plugins.inventory.constructed.InventoryModule.host_groupvars,120,5,4,1,4,0,0,8.0,4.0,0.0,D:\BaiduNetdiskDownload\graduation_project\project_folder\ansible\plugins\inventory\constructed.py,120.0
ansible.plugins.inventory.constructed.InventoryModule.host_vars,129,3,2,1,2,0,0,8.0,4.0,0.0,D:\BaiduNetdiskDownload\graduation_project\project_folder\ansible\plugins\inventory\constructed.py,129.0
ansible.plugins.inventory.constructed.InventoryModule.parse,138,7,7,0,7,0,0,41.0,4.0,0.0,D:\BaiduNetdiskDownload\graduation_project\project_folder\ansible\plugins\inventory\constructed.py,138.0
ansible.plugins.inventory.generator.InventoryModule.add_parents,106,6,4,2,4,1,1,13.0,5.0,0.0,D:\BaiduNetdiskDownload\graduation_project\project_folder\ansible\plugins\inventory\generator.py,106.0
ansible.plugins.inventory.generator.InventoryModule.parse,120,4,4,0,4,0,0,15.0,4.0,0.0,D:\BaiduNetdiskDownload\graduation_project\project_folder\ansible\plugins\inventory\generator.py,120.0
ansible.plugins.inventory.generator.InventoryModule.template,102,3,1,2,1,0,0,3.0,3.0,0.0,D:\BaiduNetdiskDownload\graduation_project\project_folder\ansible\plugins\inventory\generator.py,102.0
ansible.plugins.inventory.host_list.InventoryModule.parse,46,5,5,0,5,0,0,20.0,4.0,0.0,D:\BaiduNetdiskDownload\graduation_project\project_folder\ansible\plugins\inventory\host_list.py,46.0
ansible.plugins.inventory.host_list.InventoryModule.verify_file,38,1,1,0,1,0,0,7.0,2.0,0.0,D:\BaiduNetdiskDownload\graduation_project\project_folder\ansible\plugins\inventory\host_list.py,38.0
ansible.plugins.inventory.ini.InventoryModule._add_pending_children,250,4,2,2,2,1,1,6.0,3.0,0.0,D:\BaiduNetdiskDownload\graduation_project\project_folder\ansible\plugins\inventory\ini.py,250.0
ansible.plugins.inventory.ini.InventoryModule._compile_patterns,357,2,1,1,1,0,0,39.0,1.0,0.0,D:\BaiduNetdiskDownload\graduation_project\project_folder\ansible\plugins\inventory\ini.py,357.0
ansible.plugins.inventory.ini.InventoryModule._expand_hostpattern,319,3,2,1,2,0,0,17.0,2.0,0.0,D:\BaiduNetdiskDownload\graduation_project\project_folder\ansible\plugins\inventory\ini.py,319.0
ansible.plugins.inventory.ini.InventoryModule._parse,142,19,18,1,18,0,0,107.0,3.0,0.0,D:\BaiduNetdiskDownload\graduation_project\project_folder\ansible\plugins\inventory\ini.py,142.0
ansible.plugins.inventory.ini.InventoryModule._parse_group_name,257,3,2,1,2,0,0,11.0,2.0,0.0,D:\BaiduNetdiskDownload\graduation_project\project_folder\ansible\plugins\inventory\ini.py,257.0
ansible.plugins.inventory.ini.InventoryModule._parse_host_definition,286,5,4,1,4,0,0,32.0,2.0,0.0,D:\BaiduNetdiskDownload\graduation_project\project_folder\ansible\plugins\inventory\ini.py,286.0
ansible.plugins.inventory.ini.InventoryModule._parse_value,338,3,1,2,1,0,0,18.0,1.0,0.0,D:\BaiduNetdiskDownload\graduation_project\project_folder\ansible\plugins\inventory\ini.py,338.0
ansible.plugins.inventory.ini.InventoryModule._parse_variable_definition,269,5,4,1,4,0,0,16.0,2.0,0.0,D:\BaiduNetdiskDownload\graduation_project\project_folder\ansible\plugins\inventory\ini.py,269.0
ansible.plugins.inventory.ini.InventoryModule._raise_error,139,5,1,4,1,0,0,2.0,2.0,0.0,D:\BaiduNetdiskDownload\graduation_project\project_folder\ansible\plugins\inventory\ini.py,139.0
ansible.plugins.inventory.ini.InventoryModule.parse,103,7,7,0,7,0,0,35.0,4.0,0.0,D:\BaiduNetdiskDownload\graduation_project\project_folder\ansible\plugins\inventory\ini.py,103.0
ansible.plugins.inventory.script.InventoryModule._parse_group,273,5,4,1,4,0,0,29.0,3.0,0.0,D:\BaiduNetdiskDownload\graduation_project\project_folder\ansible\plugins\inventory\script.py,273.0
ansible.plugins.inventory.script.InventoryModule.get_host_variables,303,4,3,1,3,0,0,19.0,3.0,0.0,D:\BaiduNetdiskDownload\graduation_project\project_folder\ansible\plugins\inventory\script.py,303.0
ansible.plugins.inventory.script.InventoryModule.parse,200,9,9,0,9,0,0,72.0,4.0,0.0,D:\BaiduNetdiskDownload\graduation_project\project_folder\ansible\plugins\inventory\script.py,200.0
ansible.plugins.inventory.script.InventoryModule.verify_file,179,2,2,0,2,0,0,20.0,2.0,0.0,D:\BaiduNetdiskDownload\graduation_project\project_folder\ansible\plugins\inventory\script.py,179.0
ansible.plugins.inventory.toml.AnsibleTomlEncoder.__init__,135,1,0,1,0,0,0,9.0,3.0,0.0,D:\BaiduNetdiskDownload\graduation_project\project_folder\ansible\plugins\inventory\toml.py,135.0
ansible.plugins.inventory.toml.InventoryModule._load_file,240,7,6,1,6,0,0,26.0,2.0,0.0,D:\BaiduNetdiskDownload\graduation_project\project_folder\ansible\plugins\inventory\toml.py,240.0
ansible.plugins.inventory.toml.InventoryModule._parse_group,196,7,5,2,5,1,1,43.0,3.0,0.0,D:\BaiduNetdiskDownload\graduation_project\project_folder\ansible\plugins\inventory\toml.py,196.0
ansible.plugins.inventory.toml.InventoryModule.parse,267,2,2,0,2,0,0,24.0,4.0,0.0,D:\BaiduNetdiskDownload\graduation_project\project_folder\ansible\plugins\inventory\toml.py,267.0
ansible.plugins.inventory.toml.convert_yaml_objects_to_native,167,3,2,1,2,1,1,24.0,1.0,0.0,D:\BaiduNetdiskDownload\graduation_project\project_folder\ansible\plugins\inventory\toml.py,167.0
ansible.plugins.inventory.yaml.InventoryModule._parse_group,123,9,7,2,7,1,1,48.0,3.0,0.0,D:\BaiduNetdiskDownload\graduation_project\project_folder\ansible\plugins\inventory\yaml.py,123.0
ansible.plugins.inventory.yaml.InventoryModule._parse_host,172,1,0,1,0,0,0,11.0,2.0,0.0,D:\BaiduNetdiskDownload\graduation_project\project_folder\ansible\plugins\inventory\yaml.py,172.0
ansible.plugins.inventory.yaml.InventoryModule.parse,97,2,2,0,2,0,0,25.0,4.0,0.0,D:\BaiduNetdiskDownload\graduation_project\project_folder\ansible\plugins\inventory\yaml.py,97.0
ansible.plugins.list._list_j2_plugins_from_file,112,3,2,1,2,0,0,5.0,4.0,0.0,D:\BaiduNetdiskDownload\graduation_project\project_folder\ansible\plugins\list.py,112.0
ansible.plugins.list._list_plugins_from_paths,45,11,9,2,9,1,1,65.0,3.0,0.0,D:\BaiduNetdiskDownload\graduation_project\project_folder\ansible\plugins\list.py,45.0
ansible.plugins.list.get_composite_name,28,6,5,1,5,0,0,15.0,4.0,0.0,D:\BaiduNetdiskDownload\graduation_project\project_folder\ansible\plugins\list.py,28.0
ansible.plugins.list.list_collection_plugins,119,8,7,1,7,0,0,52.0,2.0,0.0,D:\BaiduNetdiskDownload\graduation_project\project_folder\ansible\plugins\list.py,119.0
ansible.plugins.list.list_plugin_classes,213,1,1,0,1,0,0,3.0,1.0,0.0,D:\BaiduNetdiskDownload\graduation_project\project_folder\ansible\plugins\list.py,213.0
ansible.plugins.list.list_plugin_files,208,1,1,0,1,0,0,3.0,1.0,0.0,D:\BaiduNetdiskDownload\graduation_project\project_folder\ansible\plugins\list.py,208.0
ansible.plugins.list.list_plugin_names,204,1,1,0,1,0,0,2.0,1.0,0.0,D:\BaiduNetdiskDownload\graduation_project\project_folder\ansible\plugins\list.py,204.0
ansible.plugins.list.list_plugins,173,12,6,6,6,0,0,28.0,1.0,0.0,D:\BaiduNetdiskDownload\graduation_project\project_folder\ansible\plugins\list.py,173.0
ansible.plugins.loader.Jinja2Loader.__init__,1116,1,0,1,0,0,0,4.0,6.0,0.0,D:\BaiduNetdiskDownload\graduation_project\project_folder\ansible\plugins\loader.py,1116.0
ansible.plugins.loader.Jinja2Loader._ensure_non_collection_wrappers,1320,11,9,2,9,0,0,46.0,3.0,0.0,D:\BaiduNetdiskDownload\graduation_project\project_folder\ansible\plugins\loader.py,1320.0
ansible.plugins.loader.Jinja2Loader.all,1305,4,4,0,4,0,0,14.0,3.0,0.0,D:\BaiduNetdiskDownload\graduation_project\project_folder\ansible\plugins\loader.py,1305.0
ansible.plugins.loader.Jinja2Loader.get_contained_plugins,1132,8,7,1,7,0,0,35.0,4.0,0.0,D:\BaiduNetdiskDownload\graduation_project\project_folder\ansible\plugins\loader.py,1132.0
ansible.plugins.loader.Jinja2Loader.get_with_context,1170,18,18,0,18,0,0,134.0,4.0,0.0,D:\BaiduNetdiskDownload\graduation_project\project_folder\ansible\plugins\loader.py,1170.0
ansible.plugins.loader.Jinja2Loader.method_map_name,1129,1,1,0,1,0,0,2.0,1.0,0.0,D:\BaiduNetdiskDownload\graduation_project\project_folder\ansible\plugins\loader.py,1129.0
ansible.plugins.loader.PluginLoadContext.__init__,119,3,0,3,0,0,0,18.0,1.0,0.0,D:\BaiduNetdiskDownload\graduation_project\project_folder\ansible\plugins\loader.py,119.0
ansible.plugins.loader.PluginLoadContext.nope,193,2,0,2,0,0,0,5.0,2.0,0.0,D:\BaiduNetdiskDownload\graduation_project\project_folder\ansible\plugins\loader.py,193.0
ansible.plugins.loader.PluginLoadContext.record_deprecation,153,4,3,1,3,0,0,23.0,4.0,0.0,D:\BaiduNetdiskDownload\graduation_project\project_folder\ansible\plugins\loader.py,153.0
ansible.plugins.loader.PluginLoadContext.redirect,187,2,1,1,1,0,0,5.0,2.0,0.0,D:\BaiduNetdiskDownload\graduation_project\project_folder\ansible\plugins\loader.py,187.0
ansible.plugins.loader.PluginLoadContext.resolve,177,4,0,4,0,0,0,13.0,1.0,0.0,D:\BaiduNetdiskDownload\graduation_project\project_folder\ansible\plugins\loader.py,139.0
ansible.plugins.loader.PluginLoadContext.resolved_fqcn,139,2,2,0,2,0,0,13.0,1.0,0.0,D:\BaiduNetdiskDownload\graduation_project\project_folder\ansible\plugins\loader.py,139.0
ansible.plugins.loader.PluginLoader.__init__,208,2,0,2,0,0,0,35.0,5.0,0.0,D:\BaiduNetdiskDownload\graduation_project\project_folder\ansible\plugins\loader.py,208.0
ansible.plugins.loader.PluginLoader.__repr__,248,1,1,0,1,0,0,2.0,1.0,0.0,D:\BaiduNetdiskDownload\graduation_project\project_folder\ansible\plugins\loader.py,248.0
ansible.plugins.loader.PluginLoader.__setstate__,268,1,1,0,1,0,0,18.0,2.0,0.0,D:\BaiduNetdiskDownload\graduation_project\project_folder\ansible\plugins\loader.py,268.0
ansible.plugins.loader.PluginLoader._all_directories,318,2,1,1,1,0,0,8.0,2.0,0.0,D:\BaiduNetdiskDownload\graduation_project\project_folder\ansible\plugins\loader.py,318.0
ansible.plugins.loader.PluginLoader._clear_caches,251,1,0,1,0,0,0,16.0,1.0,0.0,D:\BaiduNetdiskDownload\graduation_project\project_folder\ansible\plugins\loader.py,251.0
ansible.plugins.loader.PluginLoader._display_plugin_load,940,4,2,2,2,0,0,12.0,5.0,0.0,D:\BaiduNetdiskDownload\graduation_project\project_folder\ansible\plugins\loader.py,940.0
ansible.plugins.loader.PluginLoader._find_fq_plugin,469,16,14,2,14,0,0,108.0,4.0,0.0,D:\BaiduNetdiskDownload\graduation_project\project_folder\ansible\plugins\loader.py,469.0
ansible.plugins.loader.PluginLoader._find_plugin_legacy,689,17,16,1,16,0,5,106.0,3.0,0.0,D:\BaiduNetdiskDownload\graduation_project\project_folder\ansible\plugins\loader.py,689.0
ansible.plugins.loader.PluginLoader._get_package_paths,327,4,3,1,3,0,0,14.0,1.0,0.0,D:\BaiduNetdiskDownload\graduation_project\project_folder\ansible\plugins\loader.py,327.0
ansible.plugins.loader.PluginLoader._get_paths,395,3,1,2,1,0,0,52.0,1.0,0.0,D:\BaiduNetdiskDownload\graduation_project\project_folder\ansible\plugins\loader.py,342.0
ansible.plugins.loader.PluginLoader._get_paths_with_context,342,11,6,5,6,0,0,52.0,1.0,0.0,D:\BaiduNetdiskDownload\graduation_project\project_folder\ansible\plugins\loader.py,342.0
ansible.plugins.loader.PluginLoader._load_config_defs,401,6,4,2,4,0,0,22.0,4.0,0.0,D:\BaiduNetdiskDownload\graduation_project\project_folder\ansible\plugins\loader.py,401.0
ansible.plugins.loader.PluginLoader._load_module_source,809,5,2,3,2,0,0,30.0,3.0,0.0,D:\BaiduNetdiskDownload\graduation_project\project_folder\ansible\plugins\loader.py,809.0
ansible.plugins.loader.PluginLoader._query_collection_routing_meta,438,3,2,1,2,0,0,30.0,3.0,0.0,D:\BaiduNetdiskDownload\graduation_project\project_folder\ansible\plugins\loader.py,438.0
ansible.plugins.loader.PluginLoader._resolve_plugin_step,616,8,7,1,7,0,5,72.0,2.0,0.0,D:\BaiduNetdiskDownload\graduation_project\project_folder\ansible\plugins\loader.py,616.0
ansible.plugins.loader.PluginLoader._update_object,840,8,3,5,3,0,0,18.0,4.0,0.0,D:\BaiduNetdiskDownload\graduation_project\project_folder\ansible\plugins\loader.py,840.0
ansible.plugins.loader.PluginLoader.add_directory,424,6,3,3,3,0,0,13.0,2.0,0.0,D:\BaiduNetdiskDownload\graduation_project\project_folder\ansible\plugins\loader.py,424.0
ansible.plugins.loader.PluginLoader.all,953,15,14,1,14,0,0,153.0,3.0,0.0,D:\BaiduNetdiskDownload\graduation_project\project_folder\ansible\plugins\loader.py,953.0
ansible.plugins.loader.PluginLoader.find_plugin,578,2,1,1,1,0,0,7.0,2.0,0.0,D:\BaiduNetdiskDownload\graduation_project\project_folder\ansible\plugins\loader.py,578.0
ansible.plugins.loader.PluginLoader.find_plugin_with_context,586,13,4,9,4,0,5,28.0,2.0,0.0,D:\BaiduNetdiskDownload\graduation_project\project_folder\ansible\plugins\loader.py,586.0
ansible.plugins.loader.PluginLoader.format_paths,305,3,1,2,1,0,0,9.0,2.0,0.0,D:\BaiduNetdiskDownload\graduation_project\project_folder\ansible\plugins\loader.py,305.0
ansible.plugins.loader.PluginLoader.get,859,5,1,4,1,0,5,2.0,4.0,0.0,D:\BaiduNetdiskDownload\graduation_project\project_folder\ansible\plugins\loader.py,859.0
ansible.plugins.loader.PluginLoader.get_with_context,862,11,9,2,9,0,5,77.0,4.0,0.0,D:\BaiduNetdiskDownload\graduation_project\project_folder\ansible\plugins\loader.py,862.0
ansible.plugins.loader.PluginLoader.has_plugin,796,8,4,4,4,0,0,10.0,2.0,0.0,D:\BaiduNetdiskDownload\graduation_project\project_folder\ansible\plugins\loader.py,796.0
ansible.plugins.loader.PluginLoader.print_paths,315,2,2,0,2,0,0,2.0,1.0,0.0,D:\BaiduNetdiskDownload\graduation_project\project_folder\ansible\plugins\loader.py,315.0
ansible.plugins.loader.PluginPathContext.__init__,113,2,0,2,0,0,0,3.0,3.0,0.0,D:\BaiduNetdiskDownload\graduation_project\project_folder\ansible\plugins\loader.py,113.0
ansible.plugins.loader._configure_collection_loader,1471,4,3,1,3,0,0,15.0,0.0,0.0,D:\BaiduNetdiskDownload\graduation_project\project_folder\ansible\plugins\loader.py,1471.0
ansible.plugins.loader._does_collection_support_ansible_version,1455,3,2,1,2,0,0,14.0,2.0,0.0,D:\BaiduNetdiskDownload\graduation_project\project_folder\ansible\plugins\loader.py,1455.0
ansible.plugins.loader._load_plugin_filter,1379,8,7,1,7,0,0,54.0,1.0,0.0,D:\BaiduNetdiskDownload\graduation_project\project_folder\ansible\plugins\loader.py,1379.0
ansible.plugins.loader._on_collection_load_handler,1436,6,6,0,6,0,0,17.0,2.0,0.0,D:\BaiduNetdiskDownload\graduation_project\project_folder\ansible\plugins\loader.py,1436.0
ansible.plugins.loader.add_all_plugin_dirs,59,9,5,4,5,0,0,11.0,1.0,0.0,D:\BaiduNetdiskDownload\graduation_project\project_folder\ansible\plugins\loader.py,59.0
ansible.plugins.loader.add_dirs_to_loader,105,1,1,0,1,0,0,5.0,2.0,0.0,D:\BaiduNetdiskDownload\graduation_project\project_folder\ansible\plugins\loader.py,105.0
ansible.plugins.loader.get_all_plugin_loaders,55,3,1,2,1,0,0,2.0,1.0,0.0,D:\BaiduNetdiskDownload\graduation_project\project_folder\ansible\plugins\loader.py,55.0
ansible.plugins.loader.get_fqcr_and_name,1368,2,1,1,1,0,0,9.0,1.0,0.0,D:\BaiduNetdiskDownload\graduation_project\project_folder\ansible\plugins\loader.py,1368.0
ansible.plugins.loader.get_shell_plugin,72,4,3,1,3,0,0,31.0,0.0,0.0,D:\BaiduNetdiskDownload\graduation_project\project_folder\ansible\plugins\loader.py,72.0
ansible.plugins.loader.init_plugin_loader,1488,4,2,2,2,0,0,12.0,0.0,0.0,D:\BaiduNetdiskDownload\graduation_project\project_folder\ansible\plugins\loader.py,1488.0
ansible.plugins.lookup.__init__.LookupBase._combine,60,3,2,1,2,0,0,6.0,2.0,0.0,D:\BaiduNetdiskDownload\graduation_project\project_folder\ansible\plugins\lookup\__init__.py,60.0
ansible.plugins.lookup.__init__.LookupBase._deprecate_inline_kv,125,2,0,2,0,0,0,4.0,1.0,0.0,D:\BaiduNetdiskDownload\graduation_project\project_folder\ansible\plugins\lookup\__init__.py,125.0
ansible.plugins.lookup.__init__.LookupBase._flatten,50,7,2,5,2,0,0,8.0,1.0,0.0,D:\BaiduNetdiskDownload\graduation_project\project_folder\ansible\plugins\lookup\__init__.py,50.0
ansible.plugins.lookup.__init__.LookupBase._flatten_hash_to_list,68,2,1,1,1,0,0,5.0,1.0,0.0,D:\BaiduNetdiskDownload\graduation_project\project_folder\ansible\plugins\lookup\__init__.py,68.0
ansible.plugins.lookup.__init__.LookupBase.find_file_in_search_path,106,10,3,7,3,0,0,18.0,4.0,0.0,D:\BaiduNetdiskDownload\graduation_project\project_folder\ansible\plugins\lookup\__init__.py,106.0
ansible.plugins.lookup.__init__.LookupBase.get_basedir,43,6,1,5,1,1,1,5.0,2.0,0.0,D:\BaiduNetdiskDownload\graduation_project\project_folder\ansible\plugins\lookup\__init__.py,43.0
ansible.plugins.lookup.config.LookupModule.run,129,4,4,0,4,0,0,42.0,3.0,0.0,D:\BaiduNetdiskDownload\graduation_project\project_folder\ansible\plugins\lookup\config.py,129.0
ansible.plugins.lookup.config._get_global_config,116,1,0,1,0,0,0,9.0,1.0,0.0,D:\BaiduNetdiskDownload\graduation_project\project_folder\ansible\plugins\lookup\config.py,116.0
ansible.plugins.lookup.config._get_plugin_config,97,1,0,1,0,0,0,17.0,4.0,0.0,D:\BaiduNetdiskDownload\graduation_project\project_folder\ansible\plugins\lookup\config.py,97.0
ansible.plugins.lookup.csvfile.CSVReader.__init__,122,2,1,1,1,0,0,7.0,3.0,0.0,D:\BaiduNetdiskDownload\graduation_project\project_folder\ansible\plugins\lookup\csvfile.py,122.0
ansible.plugins.lookup.csvfile.CSVReader.__next__,130,1,1,0,1,0,0,3.0,1.0,0.0,D:\BaiduNetdiskDownload\graduation_project\project_folder\ansible\plugins\lookup\csvfile.py,130.0
ansible.plugins.lookup.csvfile.CSVRecoder.__init__,104,1,0,1,0,0,0,2.0,2.0,0.0,D:\BaiduNetdiskDownload\graduation_project\project_folder\ansible\plugins\lookup\csvfile.py,104.0
ansible.plugins.lookup.csvfile.LookupModule.read_csv,142,4,3,1,3,0,0,13.0,4.0,0.0,D:\BaiduNetdiskDownload\graduation_project\project_folder\ansible\plugins\lookup\csvfile.py,142.0
ansible.plugins.lookup.csvfile.LookupModule.run,156,7,7,0,7,0,0,50.0,3.0,0.0,D:\BaiduNetdiskDownload\graduation_project\project_folder\ansible\plugins\lookup\csvfile.py,156.0
ansible.plugins.lookup.dict.LookupModule.run,63,3,3,0,3,0,0,14.0,3.0,0.0,D:\BaiduNetdiskDownload\graduation_project\project_folder\ansible\plugins\lookup\dict.py,63.0
ansible.plugins.lookup.env.LookupModule.run,67,2,2,0,2,0,0,13.0,4.0,0.0,D:\BaiduNetdiskDownload\graduation_project\project_folder\ansible\plugins\lookup\env.py,67.0
ansible.plugins.lookup.file.LookupModule.run,65,8,8,0,8,0,0,26.0,3.0,0.0,D:\BaiduNetdiskDownload\graduation_project\project_folder\ansible\plugins\lookup\file.py,65.0
ansible.plugins.lookup.fileglob.LookupModule.run,60,6,6,0,6,0,0,26.0,3.0,0.0,D:\BaiduNetdiskDownload\graduation_project\project_folder\ansible\plugins\lookup\fileglob.py,60.0
ansible.plugins.lookup.first_found.LookupModule._process_terms,166,6,4,2,4,1,1,41.0,4.0,0.0,D:\BaiduNetdiskDownload\graduation_project\project_folder\ansible\plugins\lookup\first_found.py,166.0
ansible.plugins.lookup.first_found.LookupModule.run,208,3,3,0,3,0,0,38.0,4.0,0.0,D:\BaiduNetdiskDownload\graduation_project\project_folder\ansible\plugins\lookup\first_found.py,208.0
ansible.plugins.lookup.first_found._split_on,153,5,3,2,3,1,1,9.0,2.0,0.0,D:\BaiduNetdiskDownload\graduation_project\project_folder\ansible\plugins\lookup\first_found.py,153.0
ansible.plugins.lookup.indexed_items.LookupModule.run,45,2,2,0,2,0,0,7.0,4.0,0.0,D:\BaiduNetdiskDownload\graduation_project\project_folder\ansible\plugins\lookup\indexed_items.py,45.0
ansible.plugins.lookup.ini.LookupModule.get_value,126,2,1,1,1,0,0,11.0,5.0,0.0,D:\BaiduNetdiskDownload\graduation_project\project_folder\ansible\plugins\lookup\ini.py,126.0
ansible.plugins.lookup.ini.LookupModule.run,138,11,11,0,11,0,0,73.0,3.0,0.0,D:\BaiduNetdiskDownload\graduation_project\project_folder\ansible\plugins\lookup\ini.py,138.0
ansible.plugins.lookup.ini._parse_params,94,3,2,1,2,0,0,28.0,2.0,0.0,D:\BaiduNetdiskDownload\graduation_project\project_folder\ansible\plugins\lookup\ini.py,94.0
ansible.plugins.lookup.inventory_hostnames.LookupModule.run,42,5,5,0,5,0,0,11.0,3.0,0.0,D:\BaiduNetdiskDownload\graduation_project\project_folder\ansible\plugins\lookup\inventory_hostnames.py,42.0
ansible.plugins.lookup.items.LookupModule.run,70,1,1,0,1,0,0,3.0,3.0,0.0,D:\BaiduNetdiskDownload\graduation_project\project_folder\ansible\plugins\lookup\items.py,70.0
ansible.plugins.lookup.lines.LookupModule.run,52,5,5,0,5,0,0,11.0,4.0,0.0,D:\BaiduNetdiskDownload\graduation_project\project_folder\ansible\plugins\lookup\lines.py,52.0
ansible.plugins.lookup.list.LookupModule.run,40,1,1,0,1,0,0,4.0,3.0,0.0,D:\BaiduNetdiskDownload\graduation_project\project_folder\ansible\plugins\lookup\list.py,40.0
ansible.plugins.lookup.nested.LookupModule._lookup_variables,58,3,2,1,2,0,0,9.0,3.0,0.0,D:\BaiduNetdiskDownload\graduation_project\project_folder\ansible\plugins\lookup\nested.py,58.0
ansible.plugins.lookup.nested.LookupModule.run,68,6,6,0,6,0,0,17.0,3.0,0.0,D:\BaiduNetdiskDownload\graduation_project\project_folder\ansible\plugins\lookup\nested.py,68.0
ansible.plugins.lookup.password.LookupModule._parse_parameters,302,9,8,1,8,0,0,50.0,2.0,0.0,D:\BaiduNetdiskDownload\graduation_project\project_folder\ansible\plugins\lookup\password.py,302.0
ansible.plugins.lookup.password.LookupModule.run,353,15,15,0,15,0,0,66.0,4.0,0.0,D:\BaiduNetdiskDownload\graduation_project\project_folder\ansible\plugins\lookup\password.py,353.0
ansible.plugins.lookup.password._format_content,229,1,0,1,0,0,0,25.0,2.0,0.0,D:\BaiduNetdiskDownload\graduation_project\project_folder\ansible\plugins\lookup\password.py,229.0
ansible.plugins.lookup.password._gen_candidate_chars,162,5,4,1,4,0,0,30.0,1.0,0.0,D:\BaiduNetdiskDownload\graduation_project\project_folder\ansible\plugins\lookup\password.py,162.0
ansible.plugins.lookup.password._get_lock,266,4,3,1,3,0,0,26.0,1.0,0.0,D:\BaiduNetdiskDownload\graduation_project\project_folder\ansible\plugins\lookup\password.py,266.0
ansible.plugins.lookup.password._parse_content,194,2,1,1,1,0,0,33.0,1.0,0.0,D:\BaiduNetdiskDownload\graduation_project\project_folder\ansible\plugins\lookup\password.py,194.0
ansible.plugins.lookup.password._read_password_file,146,4,3,1,3,0,0,14.0,1.0,0.0,D:\BaiduNetdiskDownload\graduation_project\project_folder\ansible\plugins\lookup\password.py,146.0
ansible.plugins.lookup.password._release_lock,294,1,0,1,0,0,0,4.0,1.0,0.0,D:\BaiduNetdiskDownload\graduation_project\project_folder\ansible\plugins\lookup\password.py,294.0
ansible.plugins.lookup.password._write_password_file,256,4,3,1,3,0,0,8.0,2.0,0.0,D:\BaiduNetdiskDownload\graduation_project\project_folder\ansible\plugins\lookup\password.py,256.0
ansible.plugins.lookup.pipe.LookupModule.run,55,5,5,0,5,0,0,20.0,4.0,0.0,D:\BaiduNetdiskDownload\graduation_project\project_folder\ansible\plugins\lookup\pipe.py,55.0
ansible.plugins.lookup.random_choice.LookupModule.run,43,1,1,0,1,0,0,10.0,3.0,0.0,D:\BaiduNetdiskDownload\graduation_project\project_folder\ansible\plugins\lookup\random_choice.py,43.0
ansible.plugins.lookup.sequence.LookupModule.generate_sequence,194,2,1,1,1,0,0,15.0,1.0,0.0,D:\BaiduNetdiskDownload\graduation_project\project_folder\ansible\plugins\lookup\sequence.py,194.0
ansible.plugins.lookup.sequence.LookupModule.parse_kv_args,142,3,2,1,2,0,0,11.0,2.0,0.0,D:\BaiduNetdiskDownload\graduation_project\project_folder\ansible\plugins\lookup\sequence.py,142.0
ansible.plugins.lookup.sequence.LookupModule.parse_simple_args,154,3,2,1,2,0,0,14.0,2.0,0.0,D:\BaiduNetdiskDownload\graduation_project\project_folder\ansible\plugins\lookup\sequence.py,154.0
ansible.plugins.lookup.sequence.LookupModule.run,210,8,8,0,8,0,0,28.0,4.0,0.0,D:\BaiduNetdiskDownload\graduation_project\project_folder\ansible\plugins\lookup\sequence.py,210.0
ansible.plugins.lookup.sequence.LookupModule.sanity_check,173,2,1,1,1,0,0,20.0,1.0,0.0,D:\BaiduNetdiskDownload\graduation_project\project_folder\ansible\plugins\lookup\sequence.py,173.0
ansible.plugins.lookup.sequence.LookupModule.set_fields,169,1,0,1,0,0,0,3.0,1.0,0.0,D:\BaiduNetdiskDownload\graduation_project\project_folder\ansible\plugins\lookup\sequence.py,169.0
ansible.plugins.lookup.subelements.LookupModule.run,97,6,6,0,6,0,0,72.0,4.0,2.0,D:\BaiduNetdiskDownload\graduation_project\project_folder\ansible\plugins\lookup\subelements.py,97.0
ansible.plugins.lookup.template.LookupModule.run,102,10,10,0,10,0,0,71.0,4.0,0.0,D:\BaiduNetdiskDownload\graduation_project\project_folder\ansible\plugins\lookup\template.py,102.0
ansible.plugins.lookup.together.LookupModule._lookup_variables,52,3,2,1,2,0,0,6.0,2.0,0.0,D:\BaiduNetdiskDownload\graduation_project\project_folder\ansible\plugins\lookup\together.py,52.0
ansible.plugins.lookup.together.LookupModule.run,59,3,3,0,3,0,0,9.0,3.0,0.0,D:\BaiduNetdiskDownload\graduation_project\project_folder\ansible\plugins\lookup\together.py,59.0
ansible.plugins.lookup.unvault.LookupModule.run,45,7,7,0,7,0,0,21.0,3.0,0.0,D:\BaiduNetdiskDownload\graduation_project\project_folder\ansible\plugins\lookup\unvault.py,45.0
ansible.plugins.lookup.url.LookupModule.run,230,8,8,0,8,0,0,46.0,3.0,0.0,D:\BaiduNetdiskDownload\graduation_project\project_folder\ansible\plugins\lookup\url.py,230.0
ansible.plugins.lookup.varnames.LookupModule.run,55,3,3,0,3,0,0,24.0,3.0,0.0,D:\BaiduNetdiskDownload\graduation_project\project_folder\ansible\plugins\lookup\varnames.py,55.0
ansible.plugins.lookup.vars.LookupModule.run,76,2,2,0,2,0,0,30.0,3.0,0.0,D:\BaiduNetdiskDownload\graduation_project\project_folder\ansible\plugins\lookup\vars.py,76.0
ansible.plugins.netconf.__init__.NetconfBase.commit,259,2,1,1,1,1,1,17.0,1.0,0.0,D:\BaiduNetdiskDownload\graduation_project\project_folder\ansible\plugins\netconf\__init__.py,259.0
ansible.plugins.netconf.__init__.NetconfBase.copy_config,192,2,1,1,1,1,1,10.0,3.0,0.0,D:\BaiduNetdiskDownload\graduation_project\project_folder\ansible\plugins\netconf\__init__.py,192.0
ansible.plugins.netconf.__init__.NetconfBase.delete_config,288,2,1,1,1,1,1,8.0,2.0,0.0,D:\BaiduNetdiskDownload\graduation_project\project_folder\ansible\plugins\netconf\__init__.py,288.0
ansible.plugins.netconf.__init__.NetconfBase.discard_changes,250,2,1,1,1,1,1,8.0,1.0,0.0,D:\BaiduNetdiskDownload\graduation_project\project_folder\ansible\plugins\netconf\__init__.py,250.0
ansible.plugins.netconf.__init__.NetconfBase.dispatch,203,2,1,1,1,1,1,26.0,1.0,0.0,D:\BaiduNetdiskDownload\graduation_project\project_folder\ansible\plugins\netconf\__init__.py,203.0
ansible.plugins.netconf.__init__.NetconfBase.edit_config,163,2,1,1,1,1,1,18.0,1.0,0.0,D:\BaiduNetdiskDownload\graduation_project\project_folder\ansible\plugins\netconf\__init__.py,163.0
ansible.plugins.netconf.__init__.NetconfBase.get,148,2,1,1,1,1,1,15.0,1.0,0.0,D:\BaiduNetdiskDownload\graduation_project\project_folder\ansible\plugins\netconf\__init__.py,132.0
ansible.plugins.netconf.__init__.NetconfBase.get_config,132,2,1,1,1,1,1,15.0,1.0,0.0,D:\BaiduNetdiskDownload\graduation_project\project_folder\ansible\plugins\netconf\__init__.py,132.0
ansible.plugins.netconf.__init__.NetconfBase.get_device_operations,344,2,2,0,2,0,0,29.0,2.0,0.0,D:\BaiduNetdiskDownload\graduation_project\project_folder\ansible\plugins\netconf\__init__.py,344.0
ansible.plugins.netconf.__init__.NetconfBase.get_schema,277,2,1,1,1,1,1,10.0,1.0,0.0,D:\BaiduNetdiskDownload\graduation_project\project_folder\ansible\plugins\netconf\__init__.py,277.0
ansible.plugins.netconf.__init__.NetconfBase.lock,230,2,1,1,1,1,1,9.0,1.0,0.0,D:\BaiduNetdiskDownload\graduation_project\project_folder\ansible\plugins\netconf\__init__.py,230.0
ansible.plugins.netconf.__init__.NetconfBase.locked,297,2,1,1,1,1,1,2.0,2.0,0.0,D:\BaiduNetdiskDownload\graduation_project\project_folder\ansible\plugins\netconf\__init__.py,297.0
ansible.plugins.netconf.__init__.NetconfBase.rpc,118,2,1,1,1,1,1,13.0,2.0,0.0,D:\BaiduNetdiskDownload\graduation_project\project_folder\ansible\plugins\netconf\__init__.py,118.0
ansible.plugins.netconf.__init__.NetconfBase.unlock,240,2,1,1,1,1,1,9.0,1.0,0.0,D:\BaiduNetdiskDownload\graduation_project\project_folder\ansible\plugins\netconf\__init__.py,240.0
ansible.plugins.netconf.__init__.NetconfBase.validate,182,2,1,1,1,1,1,9.0,1.0,0.0,D:\BaiduNetdiskDownload\graduation_project\project_folder\ansible\plugins\netconf\__init__.py,182.0
ansible.plugins.netconf.__init__.ensure_ncclient,47,3,3,0,3,0,0,7.0,1.0,2.0,D:\BaiduNetdiskDownload\graduation_project\project_folder\ansible\plugins\netconf\__init__.py,47.0
ansible.plugins.shell.__init__.ShellBase._generate_temp_dir_name,84,3,0,3,0,0,0,2.0,1.0,0.0,D:\BaiduNetdiskDownload\graduation_project\project_folder\ansible\plugins\shell\__init__.py,84.0
ansible.plugins.shell.__init__.ShellBase._normalize_system_tmpdirs,45,6,5,1,5,0,0,13.0,1.0,0.0,D:\BaiduNetdiskDownload\graduation_project\project_folder\ansible\plugins\shell\__init__.py,45.0
ansible.plugins.shell.__init__.ShellBase.append_command,225,1,0,1,0,0,0,7.0,3.0,0.0,D:\BaiduNetdiskDownload\graduation_project\project_folder\ansible\plugins\shell\__init__.py,225.0
ansible.plugins.shell.__init__.ShellBase.build_module_command,209,5,5,0,5,0,0,15.0,4.0,0.0,D:\BaiduNetdiskDownload\graduation_project\project_folder\ansible\plugins\shell\__init__.py,209.0
ansible.plugins.shell.__init__.ShellBase.chgrp,115,3,2,1,2,0,0,6.0,3.0,0.0,D:\BaiduNetdiskDownload\graduation_project\project_folder\ansible\plugins\shell\__init__.py,115.0
ansible.plugins.shell.__init__.ShellBase.chmod,101,2,2,0,2,0,0,6.0,3.0,0.0,D:\BaiduNetdiskDownload\graduation_project\project_folder\ansible\plugins\shell\__init__.py,101.0
ansible.plugins.shell.__init__.ShellBase.chown,108,2,2,0,2,0,0,6.0,3.0,0.0,D:\BaiduNetdiskDownload\graduation_project\project_folder\ansible\plugins\shell\__init__.py,108.0
ansible.plugins.shell.__init__.ShellBase.env_prefix,87,2,2,0,2,0,0,2.0,2.0,0.0,D:\BaiduNetdiskDownload\graduation_project\project_folder\ansible\plugins\shell\__init__.py,87.0
ansible.plugins.shell.__init__.ShellBase.exists,137,1,1,0,1,0,0,3.0,2.0,0.0,D:\BaiduNetdiskDownload\graduation_project\project_folder\ansible\plugins\shell\__init__.py,137.0
ansible.plugins.shell.__init__.ShellBase.expand_user,183,1,1,0,1,0,0,21.0,2.0,0.0,D:\BaiduNetdiskDownload\graduation_project\project_folder\ansible\plugins\shell\__init__.py,183.0
ansible.plugins.shell.__init__.ShellBase.get_remote_filename,94,1,1,0,1,0,0,3.0,2.0,0.0,D:\BaiduNetdiskDownload\graduation_project\project_folder\ansible\plugins\shell\__init__.py,94.0
ansible.plugins.shell.__init__.ShellBase.join_path,90,1,0,1,0,0,0,2.0,2.0,0.0,D:\BaiduNetdiskDownload\graduation_project\project_folder\ansible\plugins\shell\__init__.py,90.0
ansible.plugins.shell.__init__.ShellBase.mkdtemp,141,4,4,0,4,0,0,41.0,1.0,0.0,D:\BaiduNetdiskDownload\graduation_project\project_folder\ansible\plugins\shell\__init__.py,141.0
ansible.plugins.shell.__init__.ShellBase.path_has_trailing_slash,98,1,1,0,1,0,0,2.0,2.0,0.0,D:\BaiduNetdiskDownload\graduation_project\project_folder\ansible\plugins\shell\__init__.py,98.0
ansible.plugins.shell.__init__.ShellBase.pwd,205,1,0,1,0,0,0,3.0,1.0,0.0,D:\BaiduNetdiskDownload\graduation_project\project_folder\ansible\plugins\shell\__init__.py,205.0
ansible.plugins.shell.__init__.ShellBase.set_options,59,3,3,0,3,0,0,23.0,1.0,0.0,D:\BaiduNetdiskDownload\graduation_project\project_folder\ansible\plugins\shell\__init__.py,59.0
ansible.plugins.shell.__init__.ShellBase.set_user_facl,122,2,2,0,2,0,0,7.0,4.0,0.0,D:\BaiduNetdiskDownload\graduation_project\project_folder\ansible\plugins\shell\__init__.py,122.0
ansible.plugins.shell.cmd.ShellModule.quote,36,1,1,0,1,0,0,21.0,2.0,0.0,D:\BaiduNetdiskDownload\graduation_project\project_folder\ansible\plugins\shell\cmd.py,36.0
ansible.plugins.shell.powershell.ShellModule._encode_script,265,14,4,10,4,0,0,22.0,2.0,0.0,D:\BaiduNetdiskDownload\graduation_project\project_folder\ansible\plugins\shell\powershell.py,265.0
ansible.plugins.shell.powershell.ShellModule._escape,259,8,0,8,0,0,0,5.0,2.0,0.0,D:\BaiduNetdiskDownload\graduation_project\project_folder\ansible\plugins\shell\powershell.py,259.0
ansible.plugins.shell.powershell.ShellModule._unquote,248,15,1,14,1,0,0,10.0,2.0,0.0,D:\BaiduNetdiskDownload\graduation_project\project_folder\ansible\plugins\shell\powershell.py,248.0
ansible.plugins.shell.powershell.ShellModule.build_module_command,184,8,8,0,8,0,0,60.0,4.0,0.0,D:\BaiduNetdiskDownload\graduation_project\project_folder\ansible\plugins\shell\powershell.py,184.0
ansible.plugins.shell.powershell.ShellModule.checksum,163,3,3,0,3,0,0,20.0,4.0,0.0,D:\BaiduNetdiskDownload\graduation_project\project_folder\ansible\plugins\shell\powershell.py,163.0
ansible.plugins.shell.powershell.ShellModule.exists,147,3,3,0,3,0,0,15.0,2.0,0.0,D:\BaiduNetdiskDownload\graduation_project\project_folder\ansible\plugins\shell\powershell.py,147.0
ansible.plugins.shell.powershell.ShellModule.expand_user,134,4,4,0,4,0,0,12.0,2.0,0.0,D:\BaiduNetdiskDownload\graduation_project\project_folder\ansible\plugins\shell\powershell.py,134.0
ansible.plugins.shell.powershell.ShellModule.get_remote_filename,89,2,2,0,2,0,0,8.0,2.0,0.0,D:\BaiduNetdiskDownload\graduation_project\project_folder\ansible\plugins\shell\powershell.py,89.0
ansible.plugins.shell.powershell.ShellModule.join_path,80,2,2,0,2,0,0,8.0,2.0,0.0,D:\BaiduNetdiskDownload\graduation_project\project_folder\ansible\plugins\shell\powershell.py,80.0
ansible.plugins.shell.powershell.ShellModule.mkdtemp,119,5,5,0,5,0,0,14.0,1.0,0.0,D:\BaiduNetdiskDownload\graduation_project\project_folder\ansible\plugins\shell\powershell.py,119.0
ansible.plugins.shell.powershell.ShellModule.path_has_trailing_slash,98,2,2,0,2,0,0,4.0,2.0,0.0,D:\BaiduNetdiskDownload\graduation_project\project_folder\ansible\plugins\shell\powershell.py,98.0
ansible.plugins.shell.powershell.ShellModule.remove,112,3,3,0,3,0,0,6.0,2.0,0.0,D:\BaiduNetdiskDownload\graduation_project\project_folder\ansible\plugins\shell\powershell.py,112.0
ansible.plugins.shell.powershell._parse_clixml,32,7,5,2,5,0,0,25.0,1.0,0.0,D:\BaiduNetdiskDownload\graduation_project\project_folder\ansible\plugins\shell\powershell.py,32.0
ansible.plugins.shell.sh.ShellModule.checksum,46,2,2,0,2,0,0,33.0,3.0,0.0,D:\BaiduNetdiskDownload\graduation_project\project_folder\ansible\plugins\shell\sh.py,46.0
ansible.plugins.strategy.__init__.Debugger.__init__,1153,1,0,1,0,0,0,13.0,7.0,0.0,D:\BaiduNetdiskDownload\graduation_project\project_folder\ansible\plugins\strategy\__init__.py,1153.0
ansible.plugins.strategy.__init__.Debugger.cmdloop,1167,1,0,1,0,0,0,5.0,1.0,0.0,D:\BaiduNetdiskDownload\graduation_project\project_folder\ansible\plugins\strategy\__init__.py,1167.0
ansible.plugins.strategy.__init__.Debugger.default,1246,1,1,0,1,0,0,5.0,2.0,0.0,D:\BaiduNetdiskDownload\graduation_project\project_folder\ansible\plugins\strategy\__init__.py,1246.0
ansible.plugins.strategy.__init__.Debugger.do_EOF,1175,1,1,0,1,0,0,3.0,2.0,0.0,D:\BaiduNetdiskDownload\graduation_project\project_folder\ansible\plugins\strategy\__init__.py,1175.0
ansible.plugins.strategy.__init__.Debugger.do_pprint,1223,2,2,0,2,0,0,7.0,2.0,0.0,D:\BaiduNetdiskDownload\graduation_project\project_folder\ansible\plugins\strategy\__init__.py,1223.0
ansible.plugins.strategy.__init__.Debugger.do_quit,1179,2,1,1,1,0,0,5.0,2.0,0.0,D:\BaiduNetdiskDownload\graduation_project\project_folder\ansible\plugins\strategy\__init__.py,1179.0
ansible.plugins.strategy.__init__.Debugger.do_update_task,1201,1,1,0,1,0,0,7.0,2.0,0.0,D:\BaiduNetdiskDownload\graduation_project\project_folder\ansible\plugins\strategy\__init__.py,1201.0
ansible.plugins.strategy.__init__.Debugger.evaluate,1211,2,1,1,1,0,0,11.0,2.0,0.0,D:\BaiduNetdiskDownload\graduation_project\project_folder\ansible\plugins\strategy\__init__.py,1211.0
ansible.plugins.strategy.__init__.Debugger.execute,1233,2,1,1,1,0,0,12.0,2.0,0.0,D:\BaiduNetdiskDownload\graduation_project\project_folder\ansible\plugins\strategy\__init__.py,1233.0
ansible.plugins.strategy.__init__.NextAction.__init__,1146,1,0,1,0,0,0,2.0,1.0,0.0,D:\BaiduNetdiskDownload\graduation_project\project_folder\ansible\plugins\strategy\__init__.py,1146.0
ansible.plugins.strategy.__init__.StrategyBase.__init__,235,1,1,0,1,0,0,47.0,2.0,0.0,D:\BaiduNetdiskDownload\graduation_project\project_folder\ansible\plugins\strategy\__init__.py,235.0
ansible.plugins.strategy.__init__.StrategyBase._cond_not_supported_warn,937,2,1,1,1,0,0,2.0,2.0,0.0,D:\BaiduNetdiskDownload\graduation_project\project_folder\ansible\plugins\strategy\__init__.py,937.0
ansible.plugins.strategy.__init__.StrategyBase._copy_included_file,840,3,0,3,0,0,0,12.0,2.0,0.0,D:\BaiduNetdiskDownload\graduation_project\project_folder\ansible\plugins\strategy\__init__.py,840.0
ansible.plugins.strategy.__init__.StrategyBase._execute_meta,940,26,24,2,24,0,0,168.0,5.0,2.0,D:\BaiduNetdiskDownload\graduation_project\project_folder\ansible\plugins\strategy\__init__.py,940.0
ansible.plugins.strategy.__init__.StrategyBase._get_cached_role,1109,6,2,4,2,0,0,8.0,3.0,0.0,D:\BaiduNetdiskDownload\graduation_project\project_folder\ansible\plugins\strategy\__init__.py,1109.0
ansible.plugins.strategy.__init__.StrategyBase._load_included_file,853,12,10,2,10,0,0,60.0,3.0,0.0,D:\BaiduNetdiskDownload\graduation_project\project_folder\ansible\plugins\strategy\__init__.py,853.0
ansible.plugins.strategy.__init__.StrategyBase._process_pending_results,575,36,33,3,33,0,0,241.0,2.0,0.0,D:\BaiduNetdiskDownload\graduation_project\project_folder\ansible\plugins\strategy\__init__.py,575.0
ansible.plugins.strategy.__init__.StrategyBase._queue_task,350,9,6,3,6,0,0,85.0,5.0,0.0,D:\BaiduNetdiskDownload\graduation_project\project_folder\ansible\plugins\strategy\__init__.py,350.0
ansible.plugins.strategy.__init__.StrategyBase._set_always_delegated_facts,447,3,2,1,2,0,0,27.0,3.0,0.0,D:\BaiduNetdiskDownload\graduation_project\project_folder\ansible\plugins\strategy\__init__.py,447.0
ansible.plugins.strategy.__init__.StrategyBase._set_hosts_cache,283,6,1,5,1,0,0,14.0,2.0,0.0,D:\BaiduNetdiskDownload\graduation_project\project_folder\ansible\plugins\strategy\__init__.py,283.0
ansible.plugins.strategy.__init__.StrategyBase._take_step,914,6,4,2,4,0,0,22.0,2.0,0.0,D:\BaiduNetdiskDownload\graduation_project\project_folder\ansible\plugins\strategy\__init__.py,914.0
ansible.plugins.strategy.__init__.StrategyBase._wait_on_pending_results,817,7,5,2,5,0,0,22.0,2.0,0.0,D:\BaiduNetdiskDownload\graduation_project\project_folder\ansible\plugins\strategy\__init__.py,817.0
ansible.plugins.strategy.__init__.StrategyBase.add_tqm_variables,342,4,2,2,2,0,0,7.0,3.0,0.0,D:\BaiduNetdiskDownload\graduation_project\project_folder\ansible\plugins\strategy\__init__.py,342.0
ansible.plugins.strategy.__init__.StrategyBase.cleanup,298,6,6,0,6,0,0,11.0,1.0,0.0,D:\BaiduNetdiskDownload\graduation_project\project_folder\ansible\plugins\strategy\__init__.py,298.0
ansible.plugins.strategy.__init__.StrategyBase.get_delegated_hosts,443,2,0,2,0,0,0,3.0,3.0,0.0,D:\BaiduNetdiskDownload\graduation_project\project_folder\ansible\plugins\strategy\__init__.py,443.0
ansible.plugins.strategy.__init__.StrategyBase.get_failed_hosts,338,2,1,1,1,0,0,3.0,2.0,0.0,D:\BaiduNetdiskDownload\graduation_project\project_folder\ansible\plugins\strategy\__init__.py,338.0
ansible.plugins.strategy.__init__.StrategyBase.get_hosts_left,1118,3,1,2,1,0,0,11.0,2.0,0.0,D:\BaiduNetdiskDownload\graduation_project\project_folder\ansible\plugins\strategy\__init__.py,1118.0
ansible.plugins.strategy.__init__.StrategyBase.get_hosts_remaining,333,2,1,1,1,0,0,4.0,2.0,0.0,D:\BaiduNetdiskDownload\graduation_project\project_folder\ansible\plugins\strategy\__init__.py,333.0
ansible.plugins.strategy.__init__.StrategyBase.get_task_hosts,436,1,0,1,0,0,0,6.0,4.0,0.0,D:\BaiduNetdiskDownload\graduation_project\project_folder\ansible\plugins\strategy\__init__.py,436.0
ansible.plugins.strategy.__init__.StrategyBase.normalize_task_result,475,4,3,1,3,0,0,33.0,2.0,0.0,D:\BaiduNetdiskDownload\graduation_project\project_folder\ansible\plugins\strategy\__init__.py,475.0
ansible.plugins.strategy.__init__.StrategyBase.run,310,1,1,0,1,0,0,22.0,3.0,0.0,D:\BaiduNetdiskDownload\graduation_project\project_folder\ansible\plugins\strategy\__init__.py,310.0
ansible.plugins.strategy.__init__.StrategyBase.search_handlers_by_notification,509,10,8,2,8,0,0,64.0,3.0,0.0,D:\BaiduNetdiskDownload\graduation_project\project_folder\ansible\plugins\strategy\__init__.py,509.0
ansible.plugins.strategy.__init__.StrategyBase.update_active_connections,1130,2,0,2,0,0,0,8.0,2.0,0.0,D:\BaiduNetdiskDownload\graduation_project\project_folder\ansible\plugins\strategy\__init__.py,1130.0
ansible.plugins.strategy.__init__._get_item_vars,95,1,0,1,0,0,0,14.0,2.0,0.0,D:\BaiduNetdiskDownload\graduation_project\project_folder\ansible\plugins\strategy\__init__.py,95.0
ansible.plugins.strategy.__init__.debug_closure,156,16,15,1,15,1,1,65.0,1.0,2.0,D:\BaiduNetdiskDownload\graduation_project\project_folder\ansible\plugins\strategy\__init__.py,156.0
ansible.plugins.strategy.__init__.post_process_whens,78,4,3,1,3,0,0,15.0,4.0,0.0,D:\BaiduNetdiskDownload\graduation_project\project_folder\ansible\plugins\strategy\__init__.py,78.0
ansible.plugins.strategy.__init__.results_thread_main,111,6,6,0,6,0,0,43.0,1.0,0.0,D:\BaiduNetdiskDownload\graduation_project\project_folder\ansible\plugins\strategy\__init__.py,111.0
ansible.plugins.strategy.free.StrategyModule.run,56,31,31,0,31,0,0,259.0,3.0,0.0,D:\BaiduNetdiskDownload\graduation_project\project_folder\ansible\plugins\strategy\free.py,56.0
ansible.plugins.strategy.linear.StrategyModule._get_next_task_lockstep,55,8,7,1,7,0,0,69.0,3.0,0.0,D:\BaiduNetdiskDownload\graduation_project\project_folder\ansible\plugins\strategy\linear.py,55.0
ansible.plugins.strategy.linear.StrategyModule.run,125,30,30,0,30,0,0,287.0,3.0,0.0,D:\BaiduNetdiskDownload\graduation_project\project_folder\ansible\plugins\strategy\linear.py,125.0
ansible.plugins.terminal.__init__.TerminalBase.on_authorize,122,1,1,0,1,0,0,6.0,1.0,0.0,D:\BaiduNetdiskDownload\graduation_project\project_folder\ansible\plugins\terminal\__init__.py,122.0
ansible.plugins.terminal.__init__.TerminalBase.on_become,101,1,0,1,0,0,0,11.0,1.0,0.0,D:\BaiduNetdiskDownload\graduation_project\project_folder\ansible\plugins\terminal\__init__.py,101.0
ansible.plugins.terminal.__init__.TerminalBase.on_deauthorize,129,1,1,0,1,0,0,4.0,1.0,0.0,D:\BaiduNetdiskDownload\graduation_project\project_folder\ansible\plugins\terminal\__init__.py,129.0
ansible.plugins.terminal.__init__.TerminalBase.on_unbecome,113,1,0,1,0,0,0,8.0,1.0,0.0,D:\BaiduNetdiskDownload\graduation_project\project_folder\ansible\plugins\terminal\__init__.py,113.0
ansible.plugins.test.core.failed,42,1,0,1,0,0,0,5.0,1.0,0.0,D:\BaiduNetdiskDownload\graduation_project\project_folder\ansible\plugins\test\core.py,42.0
ansible.plugins.test.core.falsy,229,1,1,0,1,0,0,9.0,1.0,0.0,D:\BaiduNetdiskDownload\graduation_project\project_folder\ansible\plugins\test\core.py,229.0
ansible.plugins.test.core.finished,107,1,1,0,1,0,0,12.0,1.0,0.0,D:\BaiduNetdiskDownload\graduation_project\project_folder\ansible\plugins\test\core.py,107.0
ansible.plugins.test.core.match,146,34,1,33,1,0,0,3.0,1.0,0.0,D:\BaiduNetdiskDownload\graduation_project\project_folder\ansible\plugins\test\core.py,146.0
ansible.plugins.test.core.reachable,61,1,1,0,1,0,0,3.0,1.0,0.0,D:\BaiduNetdiskDownload\graduation_project\project_folder\ansible\plugins\test\core.py,61.0
ansible.plugins.test.core.regex,121,3,1,2,1,0,0,15.0,0.0,0.0,D:\BaiduNetdiskDownload\graduation_project\project_folder\ansible\plugins\test\core.py,121.0
ansible.plugins.test.core.search,151,24,1,23,1,0,0,3.0,1.0,0.0,D:\BaiduNetdiskDownload\graduation_project\project_folder\ansible\plugins\test\core.py,151.0
ansible.plugins.test.core.started,93,1,1,0,1,0,0,12.0,1.0,0.0,D:\BaiduNetdiskDownload\graduation_project\project_folder\ansible\plugins\test\core.py,93.0
ansible.plugins.test.core.success,49,1,1,0,1,0,0,3.0,1.0,0.0,D:\BaiduNetdiskDownload\graduation_project\project_folder\ansible\plugins\test\core.py,49.0
ansible.plugins.test.core.truthy,212,2,1,1,1,0,0,15.0,1.0,0.0,D:\BaiduNetdiskDownload\graduation_project\project_folder\ansible\plugins\test\core.py,212.0
ansible.plugins.test.core.unreachable,54,1,0,1,0,0,0,5.0,1.0,0.0,D:\BaiduNetdiskDownload\graduation_project\project_folder\ansible\plugins\test\core.py,54.0
ansible.plugins.test.core.version_compare,156,3,3,0,3,0,0,54.0,2.0,0.0,D:\BaiduNetdiskDownload\graduation_project\project_folder\ansible\plugins\test\core.py,156.0
ansible.plugins.test.mathstuff.issubset,23,1,0,1,0,0,0,2.0,2.0,0.0,D:\BaiduNetdiskDownload\graduation_project\project_folder\ansible\plugins\test\mathstuff.py,23.0
ansible.plugins.test.uri.is_uri,8,2,0,2,0,0,0,8.0,1.0,0.0,D:\BaiduNetdiskDownload\graduation_project\project_folder\ansible\plugins\test\uri.py,8.0
ansible.plugins.test.uri.is_url,18,1,1,0,1,0,0,11.0,1.0,0.0,D:\BaiduNetdiskDownload\graduation_project\project_folder\ansible\plugins\test\uri.py,18.0
ansible.plugins.test.uri.is_urn,31,1,1,0,1,0,0,2.0,1.0,0.0,D:\BaiduNetdiskDownload\graduation_project\project_folder\ansible\plugins\test\uri.py,31.0
ansible.plugins.vars.__init__.BaseVarsPlugin.get_vars,39,1,1,0,1,0,0,3.0,4.0,0.0,D:\BaiduNetdiskDownload\graduation_project\project_folder\ansible\plugins\vars\__init__.py,39.0
ansible.plugins.vars.host_group_vars.VarsModule.get_vars,81,5,5,0,5,0,0,72.0,4.0,0.0,D:\BaiduNetdiskDownload\graduation_project\project_folder\ansible\plugins\vars\host_group_vars.py,81.0
ansible.plugins.vars.host_group_vars.VarsModule.load_found_files,74,3,2,1,2,0,0,6.0,4.0,0.0,D:\BaiduNetdiskDownload\graduation_project\project_folder\ansible\plugins\vars\host_group_vars.py,74.0
ansible.template.__init__.AnsibleContext._is_unsafe,355,3,1,2,1,1,1,18.0,2.0,0.0,D:\BaiduNetdiskDownload\graduation_project\project_folder\ansible\template\__init__.py,355.0
ansible.template.__init__.AnsibleContext._update_unsafe,374,2,1,1,1,0,0,3.0,2.0,0.0,D:\BaiduNetdiskDownload\graduation_project\project_folder\ansible\template\__init__.py,374.0
ansible.template.__init__.AnsibleContext.get_all,383,1,1,0,1,0,0,32.0,1.0,0.0,D:\BaiduNetdiskDownload\graduation_project\project_folder\ansible\template\__init__.py,383.0
ansible.template.__init__.AnsibleContext.resolve_or_missing,378,3,2,1,2,1,1,4.0,2.0,0.0,D:\BaiduNetdiskDownload\graduation_project\project_folder\ansible\template\__init__.py,378.0
ansible.template.__init__.AnsibleEnvironment.__init__,542,1,1,0,1,0,0,10.0,3.0,0.0,D:\BaiduNetdiskDownload\graduation_project\project_folder\ansible\template\__init__.py,542.0
ansible.template.__init__.AnsibleNativeEnvironment.__init__,557,1,1,0,1,0,0,3.0,3.0,0.0,D:\BaiduNetdiskDownload\graduation_project\project_folder\ansible\template\__init__.py,557.0
ansible.template.__init__.AnsibleUndefined.__repr__,332,1,1,0,1,0,0,6.0,1.0,0.0,D:\BaiduNetdiskDownload\graduation_project\project_folder\ansible\template\__init__.py,332.0
ansible.template.__init__.JinjaPluginIntercept.__getitem__,437,4,4,0,4,0,0,42.0,2.0,0.0,D:\BaiduNetdiskDownload\graduation_project\project_folder\ansible\template\__init__.py,437.0
ansible.template.__init__.JinjaPluginIntercept.__init__,425,1,0,1,0,0,0,11.0,5.0,0.0,D:\BaiduNetdiskDownload\graduation_project\project_folder\ansible\template\__init__.py,425.0
ansible.template.__init__.JinjaPluginIntercept.__setitem__,480,2,1,1,1,1,1,2.0,3.0,0.0,D:\BaiduNetdiskDownload\graduation_project\project_folder\ansible\template\__init__.py,480.0
ansible.template.__init__.Templar.__init__,567,31,2,29,2,0,0,27.0,2.0,0.0,D:\BaiduNetdiskDownload\graduation_project\project_folder\ansible\template\__init__.py,567.0
ansible.template.__init__.Templar._compile_single_var,595,3,0,3,0,0,0,2.0,2.0,0.0,D:\BaiduNetdiskDownload\graduation_project\project_folder\ansible\template\__init__.py,595.0
ansible.template.__init__.Templar._convert_bare_variable,796,2,1,1,1,0,0,15.0,2.0,0.0,D:\BaiduNetdiskDownload\graduation_project\project_folder\ansible\template\__init__.py,796.0
ansible.template.__init__.Templar._fail_lookup,812,1,1,0,1,0,0,2.0,4.0,0.0,D:\BaiduNetdiskDownload\graduation_project\project_folder\ansible\template\__init__.py,812.0
ansible.template.__init__.Templar._get_extensions,634,2,1,1,1,0,0,15.0,1.0,0.0,D:\BaiduNetdiskDownload\graduation_project\project_folder\ansible\template\__init__.py,634.0
ansible.template.__init__.Templar._lookup,832,13,12,1,12,0,0,83.0,5.0,0.0,D:\BaiduNetdiskDownload\graduation_project\project_folder\ansible\template\__init__.py,832.0
ansible.template.__init__.Templar._now_datetime,815,2,2,0,2,0,0,11.0,1.0,0.0,D:\BaiduNetdiskDownload\graduation_project\project_folder\ansible\template\__init__.py,815.0
ansible.template.__init__.Templar._query_lookup,827,1,1,0,1,0,0,4.0,5.0,0.0,D:\BaiduNetdiskDownload\graduation_project\project_folder\ansible\template\__init__.py,827.0
ansible.template.__init__.Templar.copy_with_new_env,598,3,1,2,1,0,0,35.0,2.0,0.0,D:\BaiduNetdiskDownload\graduation_project\project_folder\ansible\template\__init__.py,598.0
ansible.template.__init__.Templar.do_template,923,14,11,3,11,0,0,101.0,2.0,0.0,D:\BaiduNetdiskDownload\graduation_project\project_folder\ansible\template\__init__.py,923.0
ansible.template.__init__.Templar.is_possibly_template,792,3,2,1,2,0,0,3.0,2.0,0.0,D:\BaiduNetdiskDownload\graduation_project\project_folder\ansible\template\__init__.py,792.0
ansible.template.__init__.Templar.is_template,776,8,2,6,2,1,1,13.0,2.0,0.0,D:\BaiduNetdiskDownload\graduation_project\project_folder\ansible\template\__init__.py,776.0
ansible.template.__init__.Templar.set_temporary_context,668,3,1,2,1,0,0,28.0,2.0,0.0,D:\BaiduNetdiskDownload\graduation_project\project_folder\ansible\template\__init__.py,668.0
ansible.template.__init__.Templar.template,697,28,8,20,8,1,1,78.0,2.0,0.0,D:\BaiduNetdiskDownload\graduation_project\project_folder\ansible\template\__init__.py,697.0
ansible.template.__init__._ansible_finalize,518,1,1,0,1,0,0,13.0,1.0,0.0,D:\BaiduNetdiskDownload\graduation_project\project_folder\ansible\template\__init__.py,518.0
ansible.template.__init__._count_newlines_from_end,245,1,0,1,0,0,0,16.0,1.0,0.0,D:\BaiduNetdiskDownload\graduation_project\project_folder\ansible\template\__init__.py,245.0
ansible.template.__init__._create_overlay,155,8,6,2,6,0,0,31.0,3.0,0.0,D:\BaiduNetdiskDownload\graduation_project\project_folder\ansible\template\__init__.py,155.0
ansible.template.__init__._escape_backslashes,112,4,3,1,3,0,0,41.0,2.0,0.0,D:\BaiduNetdiskDownload\graduation_project\project_folder\ansible\template\__init__.py,112.0
ansible.template.__init__._fail_on_undefined,495,5,3,2,3,1,1,20.0,1.0,0.0,D:\BaiduNetdiskDownload\graduation_project\project_folder\ansible\template\__init__.py,495.0
ansible.template.__init__._is_rolled,277,1,0,1,0,0,0,9.0,1.0,0.0,D:\BaiduNetdiskDownload\graduation_project\project_folder\ansible\template\__init__.py,277.0
ansible.template.__init__._unroll_iterator,288,3,1,2,1,0,0,12.0,1.0,2.0,D:\BaiduNetdiskDownload\graduation_project\project_folder\ansible\template\__init__.py,288.0
ansible.template.__init__._wrap_native_text,302,1,0,1,0,0,0,11.0,1.0,2.0,D:\BaiduNetdiskDownload\graduation_project\project_folder\ansible\template\__init__.py,302.0
ansible.template.__init__.generate_ansible_template_vars,75,6,4,2,4,0,0,35.0,1.0,0.0,D:\BaiduNetdiskDownload\graduation_project\project_folder\ansible\template\__init__.py,75.0
ansible.template.__init__.is_possibly_template,188,2,0,2,0,0,0,17.0,2.0,0.0,D:\BaiduNetdiskDownload\graduation_project\project_folder\ansible\template\__init__.py,188.0
ansible.template.__init__.is_template,207,4,2,2,2,0,0,36.0,2.0,0.0,D:\BaiduNetdiskDownload\graduation_project\project_folder\ansible\template\__init__.py,207.0
ansible.template.__init__.recursive_check_defined,263,4,2,2,2,1,1,12.0,1.0,0.0,D:\BaiduNetdiskDownload\graduation_project\project_folder\ansible\template\__init__.py,263.0
ansible.template.native_helpers.ansible_concat,74,2,2,0,2,0,0,8.0,1.0,0.0,D:\BaiduNetdiskDownload\graduation_project\project_folder\ansible\template\native_helpers.py,74.0
ansible.template.native_helpers.ansible_eval_concat,31,3,3,0,3,0,0,41.0,1.0,0.0,D:\BaiduNetdiskDownload\graduation_project\project_folder\ansible\template\native_helpers.py,31.0
ansible.template.native_helpers.ansible_native_concat,84,2,2,0,2,0,0,54.0,1.0,0.0,D:\BaiduNetdiskDownload\graduation_project\project_folder\ansible\template\native_helpers.py,84.0
ansible.template.template.AnsibleJ2Template.new_context,33,2,1,1,1,0,0,11.0,1.0,0.0,D:\BaiduNetdiskDownload\graduation_project\project_folder\ansible\template\template.py,33.0
ansible.template.vars.AnsibleJ2Vars.__getitem__,37,1,1,0,1,0,0,25.0,2.0,0.0,D:\BaiduNetdiskDownload\graduation_project\project_folder\ansible\template\vars.py,37.0
ansible.template.vars.AnsibleJ2Vars.__init__,29,3,1,2,1,0,0,7.0,3.0,0.0,D:\BaiduNetdiskDownload\graduation_project\project_folder\ansible\template\vars.py,29.0
ansible.template.vars.AnsibleJ2Vars.add_locals,63,3,1,2,1,0,0,15.0,2.0,0.0,D:\BaiduNetdiskDownload\graduation_project\project_folder\ansible\template\vars.py,63.0
ansible.template.vars._process_locals,16,2,1,1,1,0,0,8.0,1.0,0.0,D:\BaiduNetdiskDownload\graduation_project\project_folder\ansible\template\vars.py,16.0
ansible.utils._junit_xml.TestCase.get_attributes,103,2,1,1,1,0,0,9.0,1.0,0.0,D:\BaiduNetdiskDownload\graduation_project\project_folder\ansible\utils\_junit_xml.py,103.0
ansible.utils._junit_xml.TestCase.get_xml_element,113,2,2,0,2,0,0,17.0,1.0,0.0,D:\BaiduNetdiskDownload\graduation_project\project_folder\ansible\utils\_junit_xml.py,113.0
ansible.utils._junit_xml.TestResult.get_attributes,35,2,1,1,1,0,0,6.0,1.0,0.0,D:\BaiduNetdiskDownload\graduation_project\project_folder\ansible\utils\_junit_xml.py,35.0
ansible.utils._junit_xml.TestResult.get_xml_element,42,1,1,0,1,0,0,6.0,1.0,0.0,D:\BaiduNetdiskDownload\graduation_project\project_folder\ansible\utils\_junit_xml.py,42.0
ansible.utils._junit_xml.TestSuite.get_attributes,181,3,2,1,2,0,0,15.0,1.0,0.0,D:\BaiduNetdiskDownload\graduation_project\project_folder\ansible\utils\_junit_xml.py,181.0
ansible.utils._junit_xml.TestSuite.get_xml_element,197,3,3,0,3,0,0,16.0,1.0,0.0,D:\BaiduNetdiskDownload\graduation_project\project_folder\ansible\utils\_junit_xml.py,197.0
ansible.utils._junit_xml.TestSuites.get_attributes,248,2,1,1,1,0,0,10.0,1.0,0.0,D:\BaiduNetdiskDownload\graduation_project\project_folder\ansible\utils\_junit_xml.py,248.0
ansible.utils._junit_xml.TestSuites.get_xml_element,259,3,2,1,2,0,0,6.0,1.0,0.0,D:\BaiduNetdiskDownload\graduation_project\project_folder\ansible\utils\_junit_xml.py,259.0
ansible.utils._junit_xml.TestSuites.to_pretty_xml,266,3,2,1,2,0,0,3.0,1.0,0.0,D:\BaiduNetdiskDownload\graduation_project\project_folder\ansible\utils\_junit_xml.py,266.0
ansible.utils._junit_xml._attributes,271,5,1,4,1,0,0,3.0,1.0,0.0,D:\BaiduNetdiskDownload\graduation_project\project_folder\ansible\utils\_junit_xml.py,271.0
ansible.utils._junit_xml._pretty_xml,276,1,0,1,0,0,0,3.0,1.0,0.0,D:\BaiduNetdiskDownload\graduation_project\project_folder\ansible\utils\_junit_xml.py,276.0
ansible.utils.cmd_functions.run_cmd,29,3,2,1,2,0,0,37.0,1.0,0.0,D:\BaiduNetdiskDownload\graduation_project\project_folder\ansible\utils\cmd_functions.py,29.0
ansible.utils.collection_loader.__init__.resource_from_fqcr,15,6,2,4,2,0,0,11.0,1.0,0.0,D:\BaiduNetdiskDownload\graduation_project\project_folder\ansible\utils\collection_loader\__init__.py,15.0
ansible.utils.collection_loader._collection_config._AnsibleCollectionConfig.__init__,45,1,1,0,1,0,0,4.0,4.0,0.0,D:\BaiduNetdiskDownload\graduation_project\project_folder\ansible\utils\collection_loader\_collection_config.py,45.0
ansible.utils.collection_loader._collection_config._AnsibleCollectionConfig._require_finder,94,3,0,3,0,0,0,3.0,1.0,0.0,D:\BaiduNetdiskDownload\graduation_project\project_folder\ansible\utils\collection_loader\_collection_config.py,94.0
ansible.utils.collection_loader._collection_config._AnsibleCollectionConfig.collection_paths,62,2,2,0,2,0,0,3.0,1.0,0.0,D:\BaiduNetdiskDownload\graduation_project\project_folder\ansible\utils\collection_loader\_collection_config.py,62.0
ansible.utils.collection_loader._collection_config._AnsibleCollectionConfig.playbook_paths,85,2,2,0,2,0,0,3.0,2.0,0.0,D:\BaiduNetdiskDownload\graduation_project\project_folder\ansible\utils\collection_loader\_collection_config.py,85.0
ansible.utils.collection_loader._collection_config._AnsibleCollectionConfig.playbook_paths,90,2,2,0,2,0,0,3.0,2.0,0.0,D:\BaiduNetdiskDownload\graduation_project\project_folder\ansible\utils\collection_loader\_collection_config.py,85.0
ansible.utils.collection_loader._collection_config._EventSource.__iadd__,17,1,1,0,1,0,0,5.0,2.0,0.0,D:\BaiduNetdiskDownload\graduation_project\project_folder\ansible\utils\collection_loader\_collection_config.py,17.0
ansible.utils.collection_loader._collection_config._EventSource.__init__,14,1,0,1,0,0,0,2.0,1.0,0.0,D:\BaiduNetdiskDownload\graduation_project\project_folder\ansible\utils\collection_loader\_collection_config.py,14.0
ansible.utils.collection_loader._collection_config._EventSource._on_exception,31,1,0,1,0,0,0,3.0,5.0,0.0,D:\BaiduNetdiskDownload\graduation_project\project_folder\ansible\utils\collection_loader\_collection_config.py,31.0
ansible.utils.collection_loader._collection_config._EventSource.fire,35,1,1,0,1,0,0,7.0,3.0,0.0,D:\BaiduNetdiskDownload\graduation_project\project_folder\ansible\utils\collection_loader\_collection_config.py,35.0
ansible.utils.collection_loader._collection_finder.AnsibleCollectionRef.__init__,950,7,5,2,5,0,0,56.0,5.0,0.0,D:\BaiduNetdiskDownload\graduation_project\project_folder\ansible\utils\collection_loader\_collection_finder.py,950.0
ansible.utils.collection_loader._collection_finder.AnsibleCollectionRef.__repr__,1007,1,1,0,1,0,0,2.0,1.0,0.0,D:\BaiduNetdiskDownload\graduation_project\project_folder\ansible\utils\collection_loader\_collection_finder.py,1007.0
ansible.utils.collection_loader._collection_finder.AnsibleCollectionRef.from_fqcr,1015,9,8,1,8,0,3,41.0,2.0,0.0,D:\BaiduNetdiskDownload\graduation_project\project_folder\ansible\utils\collection_loader\_collection_finder.py,1015.0
ansible.utils.collection_loader._collection_finder.AnsibleCollectionRef.is_valid_collection_name,1106,3,2,1,2,0,0,17.0,1.0,0.0,D:\BaiduNetdiskDownload\graduation_project\project_folder\ansible\utils\collection_loader\_collection_finder.py,1106.0
ansible.utils.collection_loader._collection_finder.AnsibleCollectionRef.is_valid_fqcr,1090,4,2,2,2,0,3,14.0,1.0,0.0,D:\BaiduNetdiskDownload\graduation_project\project_folder\ansible\utils\collection_loader\_collection_finder.py,1090.0
ansible.utils.collection_loader._collection_finder.AnsibleCollectionRef.legacy_plugin_dir_to_plugin_type,1071,2,2,0,2,0,0,17.0,1.0,0.0,D:\BaiduNetdiskDownload\graduation_project\project_folder\ansible\utils\collection_loader\_collection_finder.py,1071.0
ansible.utils.collection_loader._collection_finder.AnsibleCollectionRef.try_parse_fqcr,1058,4,1,3,1,0,3,11.0,2.0,0.0,D:\BaiduNetdiskDownload\graduation_project\project_folder\ansible\utils\collection_loader\_collection_finder.py,1058.0
ansible.utils.collection_loader._collection_finder._AnsibleCollectionFinder.__init__,240,4,3,1,3,0,0,32.0,1.0,0.0,D:\BaiduNetdiskDownload\graduation_project\project_folder\ansible\utils\collection_loader\_collection_finder.py,240.0
ansible.utils.collection_loader._collection_finder._AnsibleCollectionFinder._ansible_collection_path_hook,301,3,3,0,3,0,0,19.0,2.0,0.0,D:\BaiduNetdiskDownload\graduation_project\project_folder\ansible\utils\collection_loader\_collection_finder.py,301.0
ansible.utils.collection_loader._collection_finder._AnsibleCollectionFinder._get_loader,350,4,2,2,2,0,0,40.0,2.0,0.0,D:\BaiduNetdiskDownload\graduation_project\project_folder\ansible\utils\collection_loader\_collection_finder.py,350.0
ansible.utils.collection_loader._collection_finder._AnsibleCollectionFinder._install,293,2,1,1,1,0,0,7.0,1.0,0.0,D:\BaiduNetdiskDownload\graduation_project\project_folder\ansible\utils\collection_loader\_collection_finder.py,293.0
ansible.utils.collection_loader._collection_finder._AnsibleCollectionFinder._reload_hack,344,1,0,1,0,0,0,5.0,2.0,0.0,D:\BaiduNetdiskDownload\graduation_project\project_folder\ansible\utils\collection_loader\_collection_finder.py,344.0
ansible.utils.collection_loader._collection_finder._AnsibleCollectionFinder._remove,274,1,0,1,0,0,0,18.0,1.0,0.0,D:\BaiduNetdiskDownload\graduation_project\project_folder\ansible\utils\collection_loader\_collection_finder.py,274.0
ansible.utils.collection_loader._collection_finder._AnsibleCollectionFinder.find_module,391,1,1,0,1,0,0,3.0,2.0,0.0,D:\BaiduNetdiskDownload\graduation_project\project_folder\ansible\utils\collection_loader\_collection_finder.py,391.0
ansible.utils.collection_loader._collection_finder._AnsibleCollectionFinder.find_spec,395,1,1,0,1,0,0,10.0,3.0,0.0,D:\BaiduNetdiskDownload\graduation_project\project_folder\ansible\utils\collection_loader\_collection_finder.py,395.0
ansible.utils.collection_loader._collection_finder._AnsibleCollectionFinder.set_playbook_paths,328,3,2,1,2,0,0,15.0,2.0,0.0,D:\BaiduNetdiskDownload\graduation_project\project_folder\ansible\utils\collection_loader\_collection_finder.py,328.0
ansible.utils.collection_loader._collection_finder._AnsibleCollectionLoader._get_subpackage_search_paths,836,5,5,0,5,0,0,50.0,2.0,0.0,D:\BaiduNetdiskDownload\graduation_project\project_folder\ansible\utils\collection_loader\_collection_finder.py,836.0
ansible.utils.collection_loader._collection_finder._AnsibleCollectionLoader._validate_args,825,1,1,0,1,0,0,4.0,1.0,0.0,D:\BaiduNetdiskDownload\graduation_project\project_folder\ansible\utils\collection_loader\_collection_finder.py,825.0
ansible.utils.collection_loader._collection_finder._AnsibleCollectionNSPkgLoader._validate_args,728,1,1,0,1,0,0,4.0,1.0,0.0,D:\BaiduNetdiskDownload\graduation_project\project_folder\ansible\utils\collection_loader\_collection_finder.py,728.0
ansible.utils.collection_loader._collection_finder._AnsibleCollectionNSPkgLoader._validate_final,733,1,1,0,1,0,0,4.0,1.0,0.0,D:\BaiduNetdiskDownload\graduation_project\project_folder\ansible\utils\collection_loader\_collection_finder.py,733.0
ansible.utils.collection_loader._collection_finder._AnsibleCollectionPkgLoader._canonicalize_meta,800,1,0,1,0,0,0,17.0,2.0,0.0,D:\BaiduNetdiskDownload\graduation_project\project_folder\ansible\utils\collection_loader\_collection_finder.py,800.0
ansible.utils.collection_loader._collection_finder._AnsibleCollectionPkgLoader._load_module,756,8,6,2,6,0,0,32.0,2.0,0.0,D:\BaiduNetdiskDownload\graduation_project\project_folder\ansible\utils\collection_loader\_collection_finder.py,756.0
ansible.utils.collection_loader._collection_finder._AnsibleCollectionPkgLoader._validate_args,741,1,1,0,1,0,0,4.0,1.0,0.0,D:\BaiduNetdiskDownload\graduation_project\project_folder\ansible\utils\collection_loader\_collection_finder.py,741.0
ansible.utils.collection_loader._collection_finder._AnsibleCollectionPkgLoader._validate_final,746,1,1,0,1,0,0,9.0,1.0,0.0,D:\BaiduNetdiskDownload\graduation_project\project_folder\ansible\utils\collection_loader\_collection_finder.py,746.0
ansible.utils.collection_loader._collection_finder._AnsibleCollectionPkgLoader.exec_module,789,1,1,0,1,0,0,3.0,2.0,0.0,D:\BaiduNetdiskDownload\graduation_project\project_folder\ansible\utils\collection_loader\_collection_finder.py,789.0
ansible.utils.collection_loader._collection_finder._AnsibleCollectionPkgLoader.load_module,796,1,1,0,1,0,0,3.0,2.0,0.0,D:\BaiduNetdiskDownload\graduation_project\project_folder\ansible\utils\collection_loader\_collection_finder.py,796.0
ansible.utils.collection_loader._collection_finder._AnsibleCollectionPkgLoaderBase.__init__,501,6,6,0,6,0,0,18.0,2.0,0.0,D:\BaiduNetdiskDownload\graduation_project\project_folder\ansible\utils\collection_loader\_collection_finder.py,501.0
ansible.utils.collection_loader._collection_finder._AnsibleCollectionPkgLoaderBase.__repr__,710,1,1,0,1,0,0,2.0,1.0,0.0,D:\BaiduNetdiskDownload\graduation_project\project_folder\ansible\utils\collection_loader\_collection_finder.py,710.0
ansible.utils.collection_loader._collection_finder._AnsibleCollectionPkgLoaderBase._get_candidate_paths,526,1,0,1,0,0,0,2.0,2.0,0.0,D:\BaiduNetdiskDownload\graduation_project\project_folder\ansible\utils\collection_loader\_collection_finder.py,526.0
ansible.utils.collection_loader._collection_finder._AnsibleCollectionPkgLoaderBase._get_subpackage_search_paths,530,2,1,1,1,0,0,3.0,2.0,0.0,D:\BaiduNetdiskDownload\graduation_project\project_folder\ansible\utils\collection_loader\_collection_finder.py,530.0
ansible.utils.collection_loader._collection_finder._AnsibleCollectionPkgLoaderBase._module_file_from_path,562,3,2,1,2,0,0,19.0,2.0,0.0,D:\BaiduNetdiskDownload\graduation_project\project_folder\ansible\utils\collection_loader\_collection_finder.py,562.0
ansible.utils.collection_loader._collection_finder._AnsibleCollectionPkgLoaderBase._new_or_existing_module,540,2,1,1,1,0,0,18.0,2.0,0.0,D:\BaiduNetdiskDownload\graduation_project\project_folder\ansible\utils\collection_loader\_collection_finder.py,540.0
ansible.utils.collection_loader._collection_finder._AnsibleCollectionPkgLoaderBase._synthetic_filename,670,1,0,1,0,0,0,2.0,2.0,0.0,D:\BaiduNetdiskDownload\graduation_project\project_folder\ansible\utils\collection_loader\_collection_finder.py,670.0
ansible.utils.collection_loader._collection_finder._AnsibleCollectionPkgLoaderBase._validate_args,521,2,1,1,1,0,0,3.0,1.0,0.0,D:\BaiduNetdiskDownload\graduation_project\project_folder\ansible\utils\collection_loader\_collection_finder.py,521.0
ansible.utils.collection_loader._collection_finder._AnsibleCollectionPkgLoaderBase._validate_final,535,1,0,1,0,0,0,2.0,1.0,0.0,D:\BaiduNetdiskDownload\graduation_project\project_folder\ansible\utils\collection_loader\_collection_finder.py,535.0
ansible.utils.collection_loader._collection_finder._AnsibleCollectionPkgLoaderBase.exec_module,585,1,1,0,1,0,0,9.0,2.0,0.0,D:\BaiduNetdiskDownload\graduation_project\project_folder\ansible\utils\collection_loader\_collection_finder.py,585.0
ansible.utils.collection_loader._collection_finder._AnsibleCollectionPkgLoaderBase.get_code,687,4,2,2,2,0,0,19.0,2.0,0.0,D:\BaiduNetdiskDownload\graduation_project\project_folder\ansible\utils\collection_loader\_collection_finder.py,687.0
ansible.utils.collection_loader._collection_finder._AnsibleCollectionPkgLoaderBase.get_data,644,4,3,1,3,0,0,25.0,2.0,0.0,D:\BaiduNetdiskDownload\graduation_project\project_folder\ansible\utils\collection_loader\_collection_finder.py,644.0
ansible.utils.collection_loader._collection_finder._AnsibleCollectionPkgLoaderBase.get_filename,673,5,3,2,3,0,0,13.0,2.0,0.0,D:\BaiduNetdiskDownload\graduation_project\project_folder\ansible\utils\collection_loader\_collection_finder.py,673.0
ansible.utils.collection_loader._collection_finder._AnsibleCollectionPkgLoaderBase.get_resource_reader,582,1,1,0,1,0,0,2.0,2.0,0.0,D:\BaiduNetdiskDownload\graduation_project\project_folder\ansible\utils\collection_loader\_collection_finder.py,582.0
ansible.utils.collection_loader._collection_finder._AnsibleCollectionPkgLoaderBase.get_source,633,3,2,1,2,0,0,10.0,2.0,0.0,D:\BaiduNetdiskDownload\graduation_project\project_folder\ansible\utils\collection_loader\_collection_finder.py,633.0
ansible.utils.collection_loader._collection_finder._AnsibleCollectionPkgLoaderBase.is_package,628,2,1,1,1,0,0,4.0,2.0,0.0,D:\BaiduNetdiskDownload\graduation_project\project_folder\ansible\utils\collection_loader\_collection_finder.py,628.0
ansible.utils.collection_loader._collection_finder._AnsibleCollectionPkgLoaderBase.iter_modules,707,1,1,0,1,0,0,2.0,2.0,0.0,D:\BaiduNetdiskDownload\graduation_project\project_folder\ansible\utils\collection_loader\_collection_finder.py,707.0
ansible.utils.collection_loader._collection_finder._AnsibleCollectionPkgLoaderBase.load_module,602,3,3,0,3,0,0,25.0,2.0,0.0,D:\BaiduNetdiskDownload\graduation_project\project_folder\ansible\utils\collection_loader\_collection_finder.py,602.0
ansible.utils.collection_loader._collection_finder._AnsibleCollectionRootPkgLoader._validate_args,715,1,1,0,1,0,0,4.0,1.0,0.0,D:\BaiduNetdiskDownload\graduation_project\project_folder\ansible\utils\collection_loader\_collection_finder.py,715.0
ansible.utils.collection_loader._collection_finder._AnsibleInternalRedirectLoader.__init__,891,3,3,0,3,0,0,18.0,3.0,0.0,D:\BaiduNetdiskDownload\graduation_project\project_folder\ansible\utils\collection_loader\_collection_finder.py,891.0
ansible.utils.collection_loader._collection_finder._AnsibleInternalRedirectLoader.exec_module,913,1,1,0,1,0,0,7.0,2.0,0.0,D:\BaiduNetdiskDownload\graduation_project\project_folder\ansible\utils\collection_loader\_collection_finder.py,913.0
ansible.utils.collection_loader._collection_finder._AnsibleInternalRedirectLoader.get_resource_reader,910,1,1,0,1,0,0,2.0,2.0,0.0,D:\BaiduNetdiskDownload\graduation_project\project_folder\ansible\utils\collection_loader\_collection_finder.py,910.0
ansible.utils.collection_loader._collection_finder._AnsibleInternalRedirectLoader.load_module,924,1,1,0,1,0,0,13.0,2.0,0.0,D:\BaiduNetdiskDownload\graduation_project\project_folder\ansible\utils\collection_loader\_collection_finder.py,924.0
ansible.utils.collection_loader._collection_finder._AnsibleNSTraversable.__init__,136,1,0,1,0,0,0,2.0,2.0,0.0,D:\BaiduNetdiskDownload\graduation_project\project_folder\ansible\utils\collection_loader\_collection_finder.py,136.0
ansible.utils.collection_loader._collection_finder._AnsibleNSTraversable.__repr__,139,1,1,0,1,0,0,2.0,1.0,0.0,D:\BaiduNetdiskDownload\graduation_project\project_folder\ansible\utils\collection_loader\_collection_finder.py,139.0
ansible.utils.collection_loader._collection_finder._AnsibleNSTraversable.glob,151,3,1,2,1,1,1,2.0,2.0,0.0,D:\BaiduNetdiskDownload\graduation_project\project_folder\ansible\utils\collection_loader\_collection_finder.py,151.0
ansible.utils.collection_loader._collection_finder._AnsibleNSTraversable.iterdir,142,2,1,1,1,1,1,2.0,1.0,0.0,D:\BaiduNetdiskDownload\graduation_project\project_folder\ansible\utils\collection_loader\_collection_finder.py,142.0
ansible.utils.collection_loader._collection_finder._AnsiblePathHookFinder.__init__,411,1,0,1,0,0,0,7.0,3.0,0.0,D:\BaiduNetdiskDownload\graduation_project\project_folder\ansible\utils\collection_loader\_collection_finder.py,411.0
ansible.utils.collection_loader._collection_finder._AnsiblePathHookFinder.__repr__,494,1,1,0,1,0,0,2.0,1.0,0.0,D:\BaiduNetdiskDownload\graduation_project\project_folder\ansible\utils\collection_loader\_collection_finder.py,494.0
ansible.utils.collection_loader._collection_finder._AnsiblePathHookFinder._get_filefinder_path_hook,420,1,1,0,1,0,0,10.0,0.0,0.0,D:\BaiduNetdiskDownload\graduation_project\project_folder\ansible\utils\collection_loader\_collection_finder.py,420.0
ansible.utils.collection_loader._collection_finder._AnsiblePathHookFinder._get_finder,433,3,1,2,1,0,0,29.0,2.0,0.0,D:\BaiduNetdiskDownload\graduation_project\project_folder\ansible\utils\collection_loader\_collection_finder.py,433.0
ansible.utils.collection_loader._collection_finder._AnsiblePathHookFinder.find_module,463,1,1,0,1,0,0,13.0,2.0,0.0,D:\BaiduNetdiskDownload\graduation_project\project_folder\ansible\utils\collection_loader\_collection_finder.py,463.0
ansible.utils.collection_loader._collection_finder._AnsiblePathHookFinder.find_spec,477,2,2,0,2,0,0,12.0,2.0,0.0,D:\BaiduNetdiskDownload\graduation_project\project_folder\ansible\utils\collection_loader\_collection_finder.py,477.0
ansible.utils.collection_loader._collection_finder._AnsiblePathHookFinder.iter_modules,490,1,1,0,1,0,0,3.0,2.0,0.0,D:\BaiduNetdiskDownload\graduation_project\project_folder\ansible\utils\collection_loader\_collection_finder.py,490.0
ansible.utils.collection_loader._collection_finder._AnsibleTraversableResources.__init__,171,2,0,2,0,0,0,3.0,3.0,0.0,D:\BaiduNetdiskDownload\graduation_project\project_folder\ansible\utils\collection_loader\_collection_finder.py,171.0
ansible.utils.collection_loader._collection_finder._AnsibleTraversableResources._ensure_package,210,3,2,1,2,0,0,6.0,2.0,0.0,D:\BaiduNetdiskDownload\graduation_project\project_folder\ansible\utils\collection_loader\_collection_finder.py,210.0
ansible.utils.collection_loader._collection_finder._AnsibleTraversableResources._get_package,183,1,0,1,0,0,0,7.0,2.0,0.0,D:\BaiduNetdiskDownload\graduation_project\project_folder\ansible\utils\collection_loader\_collection_finder.py,183.0
ansible.utils.collection_loader._collection_finder._AnsibleTraversableResources._get_path,191,1,0,1,0,0,0,7.0,2.0,0.0,D:\BaiduNetdiskDownload\graduation_project\project_folder\ansible\utils\collection_loader\_collection_finder.py,191.0
ansible.utils.collection_loader._collection_finder._AnsibleTraversableResources._is_ansible_ns_package,199,1,0,1,0,0,0,10.0,2.0,0.0,D:\BaiduNetdiskDownload\graduation_project\project_folder\ansible\utils\collection_loader\_collection_finder.py,199.0
ansible.utils.collection_loader._collection_finder._AnsibleTraversableResources.files,217,4,4,0,4,0,0,20.0,1.0,0.0,D:\BaiduNetdiskDownload\graduation_project\project_folder\ansible\utils\collection_loader\_collection_finder.py,217.0
ansible.utils.collection_loader._collection_finder._get_ancestor_redirect,1258,2,1,1,1,0,0,11.0,2.0,0.0,D:\BaiduNetdiskDownload\graduation_project\project_folder\ansible\utils\collection_loader\_collection_finder.py,1258.0
ansible.utils.collection_loader._collection_finder._get_collection_metadata,1308,8,2,6,2,0,0,16.0,1.0,0.0,D:\BaiduNetdiskDownload\graduation_project\project_folder\ansible\utils\collection_loader\_collection_finder.py,1308.0
ansible.utils.collection_loader._collection_finder._get_collection_name_from_path,1209,10,4,6,4,0,0,40.0,1.0,0.0,D:\BaiduNetdiskDownload\graduation_project\project_folder\ansible\utils\collection_loader\_collection_finder.py,1209.0
ansible.utils.collection_loader._collection_finder._get_collection_path,1125,4,3,1,3,0,0,10.0,1.0,0.0,D:\BaiduNetdiskDownload\graduation_project\project_folder\ansible\utils\collection_loader\_collection_finder.py,1125.0
ansible.utils.collection_loader._collection_finder._get_collection_playbook_path,1137,8,4,4,4,0,0,28.0,1.0,0.0,D:\BaiduNetdiskDownload\graduation_project\project_folder\ansible\utils\collection_loader\_collection_finder.py,1137.0
ansible.utils.collection_loader._collection_finder._get_collection_resource_path,1171,6,5,1,5,0,0,36.0,2.0,0.0,D:\BaiduNetdiskDownload\graduation_project\project_folder\ansible\utils\collection_loader\_collection_finder.py,1171.0
ansible.utils.collection_loader._collection_finder._get_collection_role_path,1167,2,1,1,1,0,0,2.0,1.0,0.0,D:\BaiduNetdiskDownload\graduation_project\project_folder\ansible\utils\collection_loader\_collection_finder.py,1167.0
ansible.utils.collection_loader._collection_finder._get_import_redirect,1251,1,1,0,1,0,0,5.0,2.0,0.0,D:\BaiduNetdiskDownload\graduation_project\project_folder\ansible\utils\collection_loader\_collection_finder.py,1251.0
ansible.utils.collection_loader._collection_finder._iter_modules_impl,1281,3,1,2,1,0,0,25.0,1.0,0.0,D:\BaiduNetdiskDownload\graduation_project\project_folder\ansible\utils\collection_loader\_collection_finder.py,1281.0
ansible.utils.collection_loader._collection_finder._nested_dict_get,1271,4,0,4,0,0,0,8.0,2.0,0.0,D:\BaiduNetdiskDownload\graduation_project\project_folder\ansible\utils\collection_loader\_collection_finder.py,1271.0
ansible.utils.collection_loader._collection_meta._meta_yml_to_dict,17,1,0,1,0,0,0,15.0,2.0,0.0,D:\BaiduNetdiskDownload\graduation_project\project_folder\ansible\utils\collection_loader\_collection_meta.py,17.0
ansible.utils.color.colorize,95,2,1,1,1,0,0,6.0,3.0,0.0,D:\BaiduNetdiskDownload\graduation_project\project_folder\ansible\utils\color.py,95.0
ansible.utils.color.hostcolor,103,2,1,1,1,0,0,9.0,2.0,0.0,D:\BaiduNetdiskDownload\graduation_project\project_folder\ansible\utils\color.py,103.0
ansible.utils.color.parsecolor,55,1,0,1,0,0,0,15.0,1.0,0.0,D:\BaiduNetdiskDownload\graduation_project\project_folder\ansible\utils\color.py,55.0
ansible.utils.color.stringc,72,11,3,8,3,0,0,21.0,2.0,0.0,D:\BaiduNetdiskDownload\graduation_project\project_folder\ansible\utils\color.py,72.0
ansible.utils.context_objects.CLIArgs.__init__,71,3,2,1,2,0,0,5.0,2.0,0.0,D:\BaiduNetdiskDownload\graduation_project\project_folder\ansible\utils\context_objects.py,71.0
ansible.utils.context_objects.CLIArgs.from_options,78,1,0,1,0,0,0,2.0,2.0,0.0,D:\BaiduNetdiskDownload\graduation_project\project_folder\ansible\utils\context_objects.py,78.0
ansible.utils.context_objects._make_immutable,17,7,5,2,5,1,1,31.0,1.0,0.0,D:\BaiduNetdiskDownload\graduation_project\project_folder\ansible\utils\context_objects.py,17.0
ansible.utils.display.Display.__init__,263,105,6,99,6,0,0,56.0,1.0,0.0,D:\BaiduNetdiskDownload\graduation_project\project_folder\ansible\utils\display.py,263.0
ansible.utils.display.Display._log,452,4,2,2,2,0,0,16.0,2.0,0.0,D:\BaiduNetdiskDownload\graduation_project\project_folder\ansible\utils\display.py,452.0
ansible.utils.display.Display._meets_debug,365,1,1,0,1,0,0,11.0,2.0,2.0,D:\BaiduNetdiskDownload\graduation_project\project_folder\ansible\utils\display.py,365.0
ansible.utils.display.Display._meets_verbosity,378,1,1,0,1,0,0,13.0,2.0,2.0,D:\BaiduNetdiskDownload\graduation_project\project_folder\ansible\utils\display.py,378.0
ansible.utils.display.Display._proxy,351,2,2,0,2,0,0,12.0,3.0,2.0,D:\BaiduNetdiskDownload\graduation_project\project_folder\ansible\utils\display.py,351.0
ansible.utils.display.Display._read_non_blocking_stdin,780,5,4,1,4,0,0,53.0,1.0,0.0,D:\BaiduNetdiskDownload\graduation_project\project_folder\ansible\utils\display.py,780.0
ansible.utils.display.Display._replacing_warning_handler,320,1,1,0,1,0,0,8.0,2.0,0.0,D:\BaiduNetdiskDownload\graduation_project\project_folder\ansible\utils\display.py,320.0
ansible.utils.display.Display._set_column_width,716,1,0,1,0,0,0,6.0,1.0,0.0,D:\BaiduNetdiskDownload\graduation_project\project_folder\ansible\utils\display.py,716.0
ansible.utils.display.Display._verbose_display,495,2,1,1,1,0,0,6.0,2.0,0.0,D:\BaiduNetdiskDownload\graduation_project\project_folder\ansible\utils\display.py,495.0
ansible.utils.display.Display._verbose_log,503,2,1,1,1,0,0,5.0,2.0,0.0,D:\BaiduNetdiskDownload\graduation_project\project_folder\ansible\utils\display.py,503.0
ansible.utils.display.Display.banner,603,12,6,6,6,0,0,22.0,2.0,0.0,D:\BaiduNetdiskDownload\graduation_project\project_folder\ansible\utils\display.py,603.0
ansible.utils.display.Display.banner_cowsay,627,7,6,1,6,0,0,16.0,2.0,0.0,D:\BaiduNetdiskDownload\graduation_project\project_folder\ansible\utils\display.py,627.0
ansible.utils.display.Display.debug,511,83,1,82,1,0,0,5.0,2.0,0.0,D:\BaiduNetdiskDownload\graduation_project\project_folder\ansible\utils\display.py,511.0
ansible.utils.display.Display.deprecated,560,29,5,24,5,0,0,22.0,2.0,0.0,D:\BaiduNetdiskDownload\graduation_project\project_folder\ansible\utils\display.py,560.0
ansible.utils.display.Display.display,393,126,4,122,4,0,0,58.0,2.0,0.0,D:\BaiduNetdiskDownload\graduation_project\project_folder\ansible\utils\display.py,393.0
ansible.utils.display.Display.do_var_prompt,663,6,5,1,5,0,0,52.0,2.0,0.0,D:\BaiduNetdiskDownload\graduation_project\project_folder\ansible\utils\display.py,663.0
ansible.utils.display.Display.error,645,20,2,18,2,0,0,10.0,2.0,0.0,D:\BaiduNetdiskDownload\graduation_project\project_folder\ansible\utils\display.py,645.0
ansible.utils.display.Display.get_deprecation_message,517,6,3,3,3,0,0,41.0,2.0,0.0,D:\BaiduNetdiskDownload\graduation_project\project_folder\ansible\utils\display.py,517.0
ansible.utils.display.Display.prompt,657,3,0,3,0,0,0,5.0,1.0,0.0,D:\BaiduNetdiskDownload\graduation_project\project_folder\ansible\utils\display.py,657.0
ansible.utils.display.Display.prompt_until,723,8,5,3,5,0,0,56.0,2.0,0.0,D:\BaiduNetdiskDownload\graduation_project\project_folder\ansible\utils\display.py,723.0
ansible.utils.display.Display.set_cowsay_info,339,1,0,1,0,0,0,10.0,1.0,0.0,D:\BaiduNetdiskDownload\graduation_project\project_folder\ansible\utils\display.py,339.0
ansible.utils.display.Display.set_queue,329,1,0,1,0,0,0,9.0,2.0,0.0,D:\BaiduNetdiskDownload\graduation_project\project_folder\ansible\utils\display.py,329.0
ansible.utils.display.Display.system_warning,598,1,1,0,1,0,0,3.0,2.0,0.0,D:\BaiduNetdiskDownload\graduation_project\project_folder\ansible\utils\display.py,598.0
ansible.utils.display.Display.v,469,15,1,14,1,0,0,2.0,2.0,0.0,D:\BaiduNetdiskDownload\graduation_project\project_folder\ansible\utils\display.py,469.0
ansible.utils.display.Display.verbose,487,9,2,7,2,0,0,6.0,2.0,0.0,D:\BaiduNetdiskDownload\graduation_project\project_folder\ansible\utils\display.py,487.0
ansible.utils.display.Display.vv,472,12,1,11,1,0,0,2.0,2.0,0.0,D:\BaiduNetdiskDownload\graduation_project\project_folder\ansible\utils\display.py,472.0
ansible.utils.display.Display.vvv,475,64,1,63,1,0,0,2.0,2.0,0.0,D:\BaiduNetdiskDownload\graduation_project\project_folder\ansible\utils\display.py,475.0
ansible.utils.display.Display.vvvv,478,43,1,42,1,0,0,2.0,2.0,0.0,D:\BaiduNetdiskDownload\graduation_project\project_folder\ansible\utils\display.py,478.0
ansible.utils.display.Display.vvvvv,481,27,1,26,1,0,0,2.0,2.0,0.0,D:\BaiduNetdiskDownload\graduation_project\project_folder\ansible\utils\display.py,481.0
ansible.utils.display.Display.vvvvvv,484,2,1,1,1,0,0,2.0,2.0,0.0,D:\BaiduNetdiskDownload\graduation_project\project_folder\ansible\utils\display.py,484.0
ansible.utils.display.Display.warning,584,144,2,142,2,0,0,12.0,2.0,0.0,D:\BaiduNetdiskDownload\graduation_project\project_folder\ansible\utils\display.py,584.0
ansible.utils.display.FilterBlackList.__init__,128,1,0,1,0,0,0,2.0,2.0,0.0,D:\BaiduNetdiskDownload\graduation_project\project_folder\ansible\utils\display.py,128.0
ansible.utils.display._synchronize_textiowrapper,187,2,1,1,1,0,0,17.0,2.0,3.0,D:\BaiduNetdiskDownload\graduation_project\project_folder\ansible\utils\display.py,187.0
ansible.utils.display.clear_line,227,2,1,1,1,0,0,3.0,1.0,0.0,D:\BaiduNetdiskDownload\graduation_project\project_folder\ansible\utils\display.py,227.0
ansible.utils.display.get_text_width,76,1,0,1,0,0,0,49.0,1.0,0.0,D:\BaiduNetdiskDownload\graduation_project\project_folder\ansible\utils\display.py,76.0
ansible.utils.display.setraw,206,1,0,1,0,0,0,19.0,1.0,0.0,D:\BaiduNetdiskDownload\graduation_project\project_folder\ansible\utils\display.py,206.0
ansible.utils.display.setup_prompt,232,2,1,1,1,0,0,12.0,4.0,0.0,D:\BaiduNetdiskDownload\graduation_project\project_folder\ansible\utils\display.py,232.0
ansible.utils.display.setupterm,246,1,0,1,0,0,0,13.0,1.0,0.0,D:\BaiduNetdiskDownload\graduation_project\project_folder\ansible\utils\display.py,246.0
ansible.utils.encrypt.PasslibHash.__init__,79,3,2,1,2,0,0,11.0,2.0,0.0,D:\BaiduNetdiskDownload\graduation_project\project_folder\ansible\utils\encrypt.py,79.0
ansible.utils.encrypt.PasslibHash._clean_ident,97,1,0,1,0,0,0,9.0,2.0,0.0,D:\BaiduNetdiskDownload\graduation_project\project_folder\ansible\utils\encrypt.py,97.0
ansible.utils.encrypt.PasslibHash._clean_rounds,121,1,0,1,0,0,0,11.0,2.0,0.0,D:\BaiduNetdiskDownload\graduation_project\project_folder\ansible\utils\encrypt.py,121.0
ansible.utils.encrypt.PasslibHash._clean_salt,107,3,2,1,2,0,0,13.0,2.0,0.0,D:\BaiduNetdiskDownload\graduation_project\project_folder\ansible\utils\encrypt.py,107.0
ansible.utils.encrypt.PasslibHash._hash,133,4,3,1,3,0,2,35.0,6.0,0.0,D:\BaiduNetdiskDownload\graduation_project\project_folder\ansible\utils\encrypt.py,133.0
ansible.utils.encrypt.PasslibHash.hash,91,6,4,2,4,0,2,5.0,2.0,0.0,D:\BaiduNetdiskDownload\graduation_project\project_folder\ansible\utils\encrypt.py,91.0
ansible.utils.encrypt.do_encrypt,175,7,3,4,3,0,0,4.0,2.0,0.0,D:\BaiduNetdiskDownload\graduation_project\project_folder\ansible\utils\encrypt.py,175.0
ansible.utils.encrypt.passlib_or_crypt,170,2,2,0,2,0,0,3.0,2.0,0.0,D:\BaiduNetdiskDownload\graduation_project\project_folder\ansible\utils\encrypt.py,170.0
ansible.utils.encrypt.random_password,39,3,1,2,1,0,0,15.0,0.0,0.0,D:\BaiduNetdiskDownload\graduation_project\project_folder\ansible\utils\encrypt.py,39.0
ansible.utils.encrypt.random_salt,56,2,1,1,1,0,0,7.0,0.0,0.0,D:\BaiduNetdiskDownload\graduation_project\project_folder\ansible\utils\encrypt.py,56.0
ansible.utils.fqcn.add_internal_fqcns,20,5,1,4,1,0,0,13.0,1.0,0.0,D:\BaiduNetdiskDownload\graduation_project\project_folder\ansible\utils\fqcn.py,20.0
ansible.utils.galaxy.scm_archive_collection,36,1,1,0,1,0,0,2.0,1.0,0.0,D:\BaiduNetdiskDownload\graduation_project\project_folder\ansible\utils\galaxy.py,36.0
ansible.utils.galaxy.scm_archive_resource,40,11,9,2,9,0,0,66.0,1.0,2.0,D:\BaiduNetdiskDownload\graduation_project\project_folder\ansible\utils\galaxy.py,40.0
ansible.utils.hashing.md5,84,2,1,1,1,0,0,4.0,1.0,0.0,D:\BaiduNetdiskDownload\graduation_project\project_folder\ansible\utils\hashing.py,78.0
ansible.utils.hashing.md5s,78,1,1,0,1,0,0,4.0,1.0,0.0,D:\BaiduNetdiskDownload\graduation_project\project_folder\ansible\utils\hashing.py,78.0
ansible.utils.hashing.secure_hash,43,8,3,5,3,0,0,7.0,1.0,0.0,D:\BaiduNetdiskDownload\graduation_project\project_folder\ansible\utils\hashing.py,34.0
ansible.utils.hashing.secure_hash_s,34,5,1,4,1,0,0,7.0,1.0,0.0,D:\BaiduNetdiskDownload\graduation_project\project_folder\ansible\utils\hashing.py,34.0
ansible.utils.helpers.deduplicate_list,44,2,1,1,1,0,0,6.0,1.0,0.0,D:\BaiduNetdiskDownload\graduation_project\project_folder\ansible\utils\helpers.py,44.0
ansible.utils.helpers.object_to_dict,35,1,1,0,1,0,0,7.0,1.0,0.0,D:\BaiduNetdiskDownload\graduation_project\project_folder\ansible\utils\helpers.py,35.0
ansible.utils.helpers.pct_to_int,23,3,2,1,2,0,0,10.0,2.0,0.0,D:\BaiduNetdiskDownload\graduation_project\project_folder\ansible\utils\helpers.py,23.0
ansible.utils.jsonrpc.JsonRpcServer.error,90,7,1,6,1,0,0,7.0,3.0,0.0,D:\BaiduNetdiskDownload\graduation_project\project_folder\ansible\utils\jsonrpc.py,90.0
ansible.utils.jsonrpc.JsonRpcServer.handle_request,22,9,8,1,8,0,0,51.0,2.0,0.0,D:\BaiduNetdiskDownload\graduation_project\project_folder\ansible\utils\jsonrpc.py,22.0
ansible.utils.jsonrpc.JsonRpcServer.header,77,2,0,2,0,0,0,2.0,1.0,0.0,D:\BaiduNetdiskDownload\graduation_project\project_folder\ansible\utils\jsonrpc.py,77.0
ansible.utils.jsonrpc.JsonRpcServer.internal_error,111,2,1,1,1,0,0,2.0,1.0,0.0,D:\BaiduNetdiskDownload\graduation_project\project_folder\ansible\utils\jsonrpc.py,111.0
ansible.utils.jsonrpc.JsonRpcServer.invalid_params,108,1,1,0,1,0,0,2.0,1.0,0.0,D:\BaiduNetdiskDownload\graduation_project\project_folder\ansible\utils\jsonrpc.py,108.0
ansible.utils.jsonrpc.JsonRpcServer.invalid_request,105,2,1,1,1,0,0,2.0,1.0,0.0,D:\BaiduNetdiskDownload\graduation_project\project_folder\ansible\utils\jsonrpc.py,105.0
ansible.utils.jsonrpc.JsonRpcServer.method_not_found,102,4,1,3,1,0,0,2.0,1.0,0.0,D:\BaiduNetdiskDownload\graduation_project\project_folder\ansible\utils\jsonrpc.py,102.0
ansible.utils.jsonrpc.JsonRpcServer.parse_error,99,1,1,0,1,0,0,2.0,1.0,0.0,D:\BaiduNetdiskDownload\graduation_project\project_folder\ansible\utils\jsonrpc.py,99.0
ansible.utils.jsonrpc.JsonRpcServer.register,74,5,1,4,1,0,0,2.0,2.0,0.0,D:\BaiduNetdiskDownload\graduation_project\project_folder\ansible\utils\jsonrpc.py,74.0
ansible.utils.jsonrpc.JsonRpcServer.response,80,3,2,1,2,0,0,9.0,1.0,0.0,D:\BaiduNetdiskDownload\graduation_project\project_folder\ansible\utils\jsonrpc.py,80.0
ansible.utils.listify.listify_lookup_plugin_terms,30,7,1,6,1,0,0,11.0,2.0,0.0,D:\BaiduNetdiskDownload\graduation_project\project_folder\ansible\utils\listify.py,30.0
ansible.utils.lock.lock_decorator,9,1,1,0,1,0,0,33.0,0.0,3.0,D:\BaiduNetdiskDownload\graduation_project\project_folder\ansible\utils\lock.py,9.0
ansible.utils.path.basedir,95,5,2,3,2,0,0,16.0,1.0,0.0,D:\BaiduNetdiskDownload\graduation_project\project_folder\ansible\utils\path.py,95.0
ansible.utils.path.cleanup_tmp_file,113,4,4,0,4,0,0,24.0,1.0,0.0,D:\BaiduNetdiskDownload\graduation_project\project_folder\ansible\utils\path.py,113.0
ansible.utils.path.is_subpath,139,5,2,3,2,0,0,25.0,2.0,0.0,D:\BaiduNetdiskDownload\graduation_project\project_folder\ansible\utils\path.py,139.0
ansible.utils.path.makedirs_safe,67,15,3,12,3,0,0,26.0,1.0,0.0,D:\BaiduNetdiskDownload\graduation_project\project_folder\ansible\utils\path.py,67.0
ansible.utils.path.unfrackpath,30,26,2,24,2,0,0,35.0,1.0,0.0,D:\BaiduNetdiskDownload\graduation_project\project_folder\ansible\utils\path.py,30.0
ansible.utils.plugin_docs._find_adjacent,273,4,2,2,2,0,0,19.0,3.0,0.0,D:\BaiduNetdiskDownload\graduation_project\project_folder\ansible\utils\plugin_docs.py,273.0
ansible.utils.plugin_docs._process_versions_and_dates,37,3,1,2,1,0,0,70.0,4.0,2.0,D:\BaiduNetdiskDownload\graduation_project\project_folder\ansible\utils\plugin_docs.py,37.0
ansible.utils.plugin_docs.add_collection_to_versions_and_dates,109,3,1,2,1,0,0,6.0,3.0,2.0,D:\BaiduNetdiskDownload\graduation_project\project_folder\ansible\utils\plugin_docs.py,109.0
ansible.utils.plugin_docs.add_fragments,125,15,13,2,13,0,0,80.0,3.0,0.0,D:\BaiduNetdiskDownload\graduation_project\project_folder\ansible\utils\plugin_docs.py,125.0
ansible.utils.plugin_docs.find_plugin_docfile,294,4,3,1,3,0,0,23.0,3.0,0.0,D:\BaiduNetdiskDownload\graduation_project\project_folder\ansible\utils\plugin_docs.py,294.0
ansible.utils.plugin_docs.get_docstring,207,5,3,2,3,0,0,30.0,2.0,0.0,D:\BaiduNetdiskDownload\graduation_project\project_folder\ansible\utils\plugin_docs.py,207.0
ansible.utils.plugin_docs.get_plugin_docs,319,4,3,1,3,0,0,34.0,5.0,0.0,D:\BaiduNetdiskDownload\graduation_project\project_folder\ansible\utils\plugin_docs.py,319.0
ansible.utils.plugin_docs.get_versioned_doclink,239,8,3,5,3,0,0,32.0,1.0,0.0,D:\BaiduNetdiskDownload\graduation_project\project_folder\ansible\utils\plugin_docs.py,239.0
ansible.utils.plugin_docs.merge_fragment,21,3,2,1,2,0,0,14.0,2.0,0.0,D:\BaiduNetdiskDownload\graduation_project\project_folder\ansible\utils\plugin_docs.py,21.0
ansible.utils.plugin_docs.remove_current_collection_from_versions_and_dates,117,1,1,0,1,0,0,6.0,3.0,2.0,D:\BaiduNetdiskDownload\graduation_project\project_folder\ansible\utils\plugin_docs.py,117.0
ansible.utils.py3compat.__getattr__,18,1,1,0,1,0,0,15.0,1.0,0.0,D:\BaiduNetdiskDownload\graduation_project\project_folder\ansible\utils\py3compat.py,18.0
ansible.utils.ssh_functions.check_for_controlpersist,34,3,1,2,1,0,0,19.0,1.0,0.0,D:\BaiduNetdiskDownload\graduation_project\project_folder\ansible\utils\ssh_functions.py,34.0
ansible.utils.ssh_functions.set_default_transport,55,3,2,1,2,0,0,11.0,1.0,0.0,D:\BaiduNetdiskDownload\graduation_project\project_folder\ansible\utils\ssh_functions.py,55.0
ansible.utils.unicode.unicode_wrap,26,1,1,0,1,0,0,6.0,3.0,0.0,D:\BaiduNetdiskDownload\graduation_project\project_folder\ansible\utils\unicode.py,26.0
ansible.utils.unsafe_proxy.AnsibleUnsafeBytes.decode,71,12,1,11,1,1,1,3.0,3.0,0.0,D:\BaiduNetdiskDownload\graduation_project\project_folder\ansible\utils\unsafe_proxy.py,71.0
ansible.utils.unsafe_proxy._wrap_dict,86,3,2,1,2,0,2,2.0,1.0,0.0,D:\BaiduNetdiskDownload\graduation_project\project_folder\ansible\utils\unsafe_proxy.py,86.0
ansible.utils.unsafe_proxy._wrap_sequence,90,2,1,1,1,0,2,6.0,1.0,0.0,D:\BaiduNetdiskDownload\graduation_project\project_folder\ansible\utils\unsafe_proxy.py,90.0
ansible.utils.unsafe_proxy._wrap_set,98,2,1,1,1,0,2,2.0,1.0,0.0,D:\BaiduNetdiskDownload\graduation_project\project_folder\ansible\utils\unsafe_proxy.py,98.0
ansible.utils.unsafe_proxy.to_unsafe_bytes,122,2,2,0,2,0,0,2.0,2.0,0.0,D:\BaiduNetdiskDownload\graduation_project\project_folder\ansible\utils\unsafe_proxy.py,122.0
ansible.utils.unsafe_proxy.to_unsafe_text,126,6,2,4,2,0,0,2.0,2.0,0.0,D:\BaiduNetdiskDownload\graduation_project\project_folder\ansible\utils\unsafe_proxy.py,126.0
ansible.utils.unsafe_proxy.wrap_var,102,22,4,18,4,0,2,18.0,1.0,0.0,D:\BaiduNetdiskDownload\graduation_project\project_folder\ansible\utils\unsafe_proxy.py,102.0
ansible.utils.vars._isidentifier_PY3,240,2,2,0,2,0,0,14.0,1.0,0.0,D:\BaiduNetdiskDownload\graduation_project\project_folder\ansible\utils\vars.py,240.0
ansible.utils.vars._validate_mutable_mappings,55,5,3,2,3,0,0,22.0,2.0,0.0,D:\BaiduNetdiskDownload\graduation_project\project_folder\ansible\utils\vars.py,55.0
ansible.utils.vars.combine_vars,79,36,2,34,2,0,0,12.0,2.0,0.0,D:\BaiduNetdiskDownload\graduation_project\project_folder\ansible\utils\vars.py,79.0
ansible.utils.vars.get_unique_id,43,3,1,2,1,0,0,10.0,1.0,0.0,D:\BaiduNetdiskDownload\graduation_project\project_folder\ansible\utils\vars.py,43.0
ansible.utils.vars.load_extra_vars,183,8,5,3,5,0,0,30.0,1.0,0.0,D:\BaiduNetdiskDownload\graduation_project\project_folder\ansible\utils\vars.py,183.0
ansible.utils.vars.load_options_vars,215,2,1,1,1,0,0,23.0,1.0,0.0,D:\BaiduNetdiskDownload\graduation_project\project_folder\ansible\utils\vars.py,215.0
ansible.utils.vars.merge_hash,93,12,4,8,4,1,1,88.0,2.0,0.0,D:\BaiduNetdiskDownload\graduation_project\project_folder\ansible\utils\vars.py,93.0
ansible.utils.version.SemanticVersion.__eq__,252,2,1,1,1,0,0,2.0,2.0,0.0,D:\BaiduNetdiskDownload\graduation_project\project_folder\ansible\utils\version.py,252.0
ansible.utils.version.SemanticVersion.__ge__,267,1,1,0,1,0,0,2.0,2.0,0.0,D:\BaiduNetdiskDownload\graduation_project\project_folder\ansible\utils\version.py,267.0
ansible.utils.version.SemanticVersion.__gt__,264,1,1,0,1,0,0,2.0,2.0,0.0,D:\BaiduNetdiskDownload\graduation_project\project_folder\ansible\utils\version.py,264.0
ansible.utils.version.SemanticVersion.__init__,132,8,1,7,1,0,0,10.0,1.0,0.0,D:\BaiduNetdiskDownload\graduation_project\project_folder\ansible\utils\version.py,132.0
ansible.utils.version.SemanticVersion.__le__,261,1,1,0,1,0,0,2.0,2.0,0.0,D:\BaiduNetdiskDownload\graduation_project\project_folder\ansible\utils\version.py,261.0
ansible.utils.version.SemanticVersion.__lt__,258,1,1,0,1,0,0,2.0,2.0,0.0,D:\BaiduNetdiskDownload\graduation_project\project_folder\ansible\utils\version.py,258.0
ansible.utils.version.SemanticVersion.__ne__,255,1,1,0,1,0,0,2.0,2.0,0.0,D:\BaiduNetdiskDownload\graduation_project\project_folder\ansible\utils\version.py,255.0
ansible.utils.version.SemanticVersion._cmp,217,6,1,5,1,0,0,31.0,2.0,0.0,D:\BaiduNetdiskDownload\graduation_project\project_folder\ansible\utils\version.py,217.0
ansible.utils.version.SemanticVersion.from_loose_version,147,5,3,2,3,0,0,39.0,1.0,0.0,D:\BaiduNetdiskDownload\graduation_project\project_folder\ansible\utils\version.py,147.0
ansible.utils.version.SemanticVersion.parse,187,6,5,1,5,0,0,14.0,2.0,0.0,D:\BaiduNetdiskDownload\graduation_project\project_folder\ansible\utils\version.py,187.0
ansible.utils.version._Alpha.__eq__,50,2,0,2,0,0,0,7.0,2.0,0.0,D:\BaiduNetdiskDownload\graduation_project\project_folder\ansible\utils\version.py,50.0
ansible.utils.version._Alpha.__ge__,77,1,1,0,1,0,0,2.0,2.0,0.0,D:\BaiduNetdiskDownload\graduation_project\project_folder\ansible\utils\version.py,77.0
ansible.utils.version._Alpha.__gt__,74,1,1,0,1,0,0,2.0,2.0,0.0,D:\BaiduNetdiskDownload\graduation_project\project_folder\ansible\utils\version.py,74.0
ansible.utils.version._Alpha.__init__,44,1,0,1,0,0,0,2.0,2.0,0.0,D:\BaiduNetdiskDownload\graduation_project\project_folder\ansible\utils\version.py,44.0
ansible.utils.version._Alpha.__le__,71,3,2,1,2,0,0,2.0,2.0,0.0,D:\BaiduNetdiskDownload\graduation_project\project_folder\ansible\utils\version.py,71.0
ansible.utils.version._Alpha.__lt__,61,2,0,2,0,0,0,9.0,2.0,0.0,D:\BaiduNetdiskDownload\graduation_project\project_folder\ansible\utils\version.py,61.0
ansible.utils.version._Alpha.__ne__,58,1,1,0,1,0,0,2.0,2.0,0.0,D:\BaiduNetdiskDownload\graduation_project\project_folder\ansible\utils\version.py,58.0
ansible.utils.version._Numeric.__eq__,93,2,0,2,0,0,0,7.0,2.0,0.0,D:\BaiduNetdiskDownload\graduation_project\project_folder\ansible\utils\version.py,93.0
ansible.utils.version._Numeric.__ge__,120,1,1,0,1,0,0,2.0,2.0,0.0,D:\BaiduNetdiskDownload\graduation_project\project_folder\ansible\utils\version.py,120.0
ansible.utils.version._Numeric.__gt__,117,1,1,0,1,0,0,2.0,2.0,0.0,D:\BaiduNetdiskDownload\graduation_project\project_folder\ansible\utils\version.py,117.0
ansible.utils.version._Numeric.__init__,87,1,0,1,0,0,0,2.0,2.0,0.0,D:\BaiduNetdiskDownload\graduation_project\project_folder\ansible\utils\version.py,87.0
ansible.utils.version._Numeric.__le__,114,3,2,1,2,0,0,2.0,2.0,0.0,D:\BaiduNetdiskDownload\graduation_project\project_folder\ansible\utils\version.py,114.0
ansible.utils.version._Numeric.__lt__,104,2,0,2,0,0,0,9.0,2.0,0.0,D:\BaiduNetdiskDownload\graduation_project\project_folder\ansible\utils\version.py,104.0
ansible.utils.version._Numeric.__ne__,101,1,1,0,1,0,0,2.0,2.0,0.0,D:\BaiduNetdiskDownload\graduation_project\project_folder\ansible\utils\version.py,101.0
ansible.vars.clean.clean_facts,116,9,7,2,7,0,0,41.0,1.0,0.0,D:\BaiduNetdiskDownload\graduation_project\project_folder\ansible\vars\clean.py,116.0
ansible.vars.clean.module_response_deepcopy,20,7,1,6,1,1,1,45.0,1.0,0.0,D:\BaiduNetdiskDownload\graduation_project\project_folder\ansible\vars\clean.py,20.0
ansible.vars.clean.namespace_facts,159,4,2,2,2,0,0,10.0,1.0,0.0,D:\BaiduNetdiskDownload\graduation_project\project_folder\ansible\vars\clean.py,159.0
ansible.vars.clean.remove_internal_keys,96,3,2,1,2,0,0,18.0,1.0,0.0,D:\BaiduNetdiskDownload\graduation_project\project_folder\ansible\vars\clean.py,96.0
ansible.vars.clean.strip_internal_keys,67,8,3,5,3,1,1,27.0,1.0,0.0,D:\BaiduNetdiskDownload\graduation_project\project_folder\ansible\vars\clean.py,67.0
ansible.vars.fact_cache.FactCache.__init__,21,4,1,3,1,0,0,7.0,3.0,0.0,D:\BaiduNetdiskDownload\graduation_project\project_folder\ansible\vars\fact_cache.py,21.0
ansible.vars.fact_cache.FactCache.__iter__,43,1,1,0,1,0,0,2.0,1.0,0.0,D:\BaiduNetdiskDownload\graduation_project\project_folder\ansible\vars\fact_cache.py,43.0
ansible.vars.fact_cache.FactCache.__len__,46,1,1,0,1,0,0,2.0,1.0,0.0,D:\BaiduNetdiskDownload\graduation_project\project_folder\ansible\vars\fact_cache.py,46.0
ansible.vars.fact_cache.FactCache.flush,56,2,1,1,1,1,1,3.0,1.0,0.0,D:\BaiduNetdiskDownload\graduation_project\project_folder\ansible\vars\fact_cache.py,56.0
ansible.vars.fact_cache.FactCache.keys,53,4,1,3,1,1,1,2.0,1.0,0.0,D:\BaiduNetdiskDownload\graduation_project\project_folder\ansible\vars\fact_cache.py,53.0
ansible.vars.hostvars.HostVars.__contains__,89,1,1,0,1,0,0,3.0,2.0,0.0,D:\BaiduNetdiskDownload\graduation_project\project_folder\ansible\vars\hostvars.py,89.0
ansible.vars.hostvars.HostVars.__getitem__,74,2,2,0,2,0,0,5.0,2.0,0.0,D:\BaiduNetdiskDownload\graduation_project\project_folder\ansible\vars\hostvars.py,74.0
ansible.vars.hostvars.HostVars.__init__,33,1,0,1,0,0,0,5.0,4.0,0.0,D:\BaiduNetdiskDownload\graduation_project\project_folder\ansible\vars\hostvars.py,33.0
ansible.vars.hostvars.HostVars._find_host,46,2,0,2,0,0,0,3.0,2.0,0.0,D:\BaiduNetdiskDownload\graduation_project\project_folder\ansible\vars\hostvars.py,46.0
ansible.vars.hostvars.HostVars.raw_get,50,2,1,1,1,0,0,10.0,2.0,0.0,D:\BaiduNetdiskDownload\graduation_project\project_folder\ansible\vars\hostvars.py,50.0
ansible.vars.hostvars.HostVars.set_host_facts,86,2,1,1,1,1,1,2.0,3.0,0.0,D:\BaiduNetdiskDownload\graduation_project\project_folder\ansible\vars\hostvars.py,86.0
ansible.vars.hostvars.HostVars.set_host_variable,80,2,1,1,1,1,1,2.0,4.0,0.0,D:\BaiduNetdiskDownload\graduation_project\project_folder\ansible\vars\hostvars.py,80.0
ansible.vars.hostvars.HostVars.set_nonpersistent_facts,83,2,1,1,1,1,1,2.0,3.0,0.0,D:\BaiduNetdiskDownload\graduation_project\project_folder\ansible\vars\hostvars.py,83.0
ansible.vars.hostvars.HostVarsVars.__init__,114,2,1,1,1,0,0,6.0,3.0,0.0,D:\BaiduNetdiskDownload\graduation_project\project_folder\ansible\vars\hostvars.py,114.0
ansible.vars.manager.VariableManager.__init__,74,6,5,1,5,0,0,29.0,1.0,0.0,D:\BaiduNetdiskDownload\graduation_project\project_folder\ansible\vars\manager.py,74.0
ansible.vars.manager.VariableManager._get_delegated_vars,557,12,11,1,11,0,2,134.0,4.0,0.0,D:\BaiduNetdiskDownload\graduation_project\project_folder\ansible\vars\manager.py,557.0
ansible.vars.manager.VariableManager._get_magic_variables,445,5,4,1,4,0,0,70.0,5.0,0.0,D:\BaiduNetdiskDownload\graduation_project\project_folder\ansible\vars\manager.py,445.0
ansible.vars.manager.VariableManager.clear_facts,692,3,1,2,1,0,0,5.0,2.0,0.0,D:\BaiduNetdiskDownload\graduation_project\project_folder\ansible\vars\manager.py,692.0
ansible.vars.manager.VariableManager.get_delegated_vars_and_hostname,516,5,4,1,4,0,0,40.0,4.0,0.0,D:\BaiduNetdiskDownload\graduation_project\project_folder\ansible\vars\manager.py,516.0
ansible.vars.manager.VariableManager.get_vars,140,27,25,2,25,0,2,304.0,1.0,2.0,D:\BaiduNetdiskDownload\graduation_project\project_folder\ansible\vars\manager.py,140.0
ansible.vars.manager.VariableManager.set_host_facts,698,1,1,0,1,0,0,22.0,3.0,0.0,D:\BaiduNetdiskDownload\graduation_project\project_folder\ansible\vars\manager.py,698.0
ansible.vars.manager.VariableManager.set_host_variable,734,1,1,0,1,0,0,10.0,4.0,0.0,D:\BaiduNetdiskDownload\graduation_project\project_folder\ansible\vars\manager.py,734.0
ansible.vars.manager.VarsWithSources.__contains__,788,2,1,1,1,1,1,2.0,2.0,0.0,D:\BaiduNetdiskDownload\graduation_project\project_folder\ansible\vars\manager.py,788.0
ansible.vars.manager.VarsWithSources.__getitem__,769,1,1,0,1,0,0,5.0,2.0,0.0,D:\BaiduNetdiskDownload\graduation_project\project_folder\ansible\vars\manager.py,769.0
ansible.vars.manager.VarsWithSources.__or__,794,1,1,0,1,0,0,6.0,2.0,0.0,D:\BaiduNetdiskDownload\graduation_project\project_folder\ansible\vars\manager.py,794.0
ansible.vars.manager.VarsWithSources.copy,791,4,2,2,2,1,1,2.0,1.0,0.0,D:\BaiduNetdiskDownload\graduation_project\project_folder\ansible\vars\manager.py,791.0
ansible.vars.manager.VarsWithSources.new_vars_with_sources,760,2,0,2,0,0,0,5.0,3.0,0.0,D:\BaiduNetdiskDownload\graduation_project\project_folder\ansible\vars\manager.py,760.0
ansible.vars.manager.preprocess_vars,48,3,1,2,1,0,0,19.0,1.0,0.0,D:\BaiduNetdiskDownload\graduation_project\project_folder\ansible\vars\manager.py,48.0
ansible.vars.plugins._plugin_should_run,59,1,0,1,0,0,0,20.0,2.0,0.0,D:\BaiduNetdiskDownload\graduation_project\project_folder\ansible\vars\plugins.py,59.0
ansible.vars.plugins._prime_vars_loader,20,1,0,1,0,0,0,7.0,1.0,0.0,D:\BaiduNetdiskDownload\graduation_project\project_folder\ansible\vars\plugins.py,20.0
ansible.vars.plugins.get_plugin_vars,29,4,3,1,3,0,0,26.0,4.0,0.0,D:\BaiduNetdiskDownload\graduation_project\project_folder\ansible\vars\plugins.py,29.0
ansible.vars.plugins.get_vars_from_inventory_sources,108,8,2,6,2,0,0,17.0,4.0,0.0,D:\BaiduNetdiskDownload\graduation_project\project_folder\ansible\vars\plugins.py,108.0
ansible.vars.plugins.get_vars_from_path,81,10,6,4,6,0,0,25.0,4.0,0.0,D:\BaiduNetdiskDownload\graduation_project\project_folder\ansible\vars\plugins.py,81.0
ansible.vars.reserved.get_reserved_names,29,3,2,1,2,0,0,33.0,0.0,0.0,D:\BaiduNetdiskDownload\graduation_project\project_folder\ansible\vars\reserved.py,29.0
ansible.vars.reserved.warn_if_reserved,64,2,1,1,1,0,0,12.0,1.0,0.0,D:\BaiduNetdiskDownload\graduation_project\project_folder\ansible\vars\reserved.py,64.0
